الغنائي	Lyrical
المكرم	Venerable
الرياضات	Sports
والنشاط	The
والوقت	And
صفاء	Safaa
للعرب	The
العذبة	Fresh
لتأهيل	For
بالحارس	Goalkeeper
العمالة	Employment
يشهدها	Witnessed
سنة	Year
وفاء	Wafa
نراها	See
تسليط	Shed
السائل	Liquid
سياحيا	Tourism
وفهم	And
ثلاثية	Triple
الجراد	Locust
ومجالات	And
النقال	Mobile
ضاعت	Lost
أبنائها	Sons
الابطال	Champions
المرجعية	Reference
حمدي	Hamdi
التتابع	Relay
كوادر	Cadres
يتمتعون	Enjoy
بحدود	Up
النامي	Developing
والنظم	And
عقدها	Held
فانظر	See
يقترب	Approaching
الشرائع	Canons
بميدان	Square
تعديلات	Amendments
يتجلى	Reflected
توباز	Topaz
اهله	His
اتسمت	Characterized
لتقنية	IT
الاغنام	Sheep
حفلات	Concerts
المنظومة	System
جاي	Jay
فأخذ	Took
بحركة	Movement
وأمام	And
لسعادة	HE
آخره	Etc
تراجعا	Down
سويسرا	Switzerland
موظفا	Employees
هدفنا	Our
المتتالية	Successive
بدايته	Beginning
فكذلك	So
الفنى	Download
واربعين	Forty
اختصاصات	Competencies
أسوة	Like
بصيرة	Insightful
وحكمة	And
وزوجته	And
وبقية	The
واقتصادية	And
اخصائي	Specialist
ينادي	Call
أفئدة	Hearts
تراثية	Heritage
يستدعي	Calls
والتأمين	And
الصيغة	Formula
الافراج	Release
الناقلات	Tanker
بنو	Sons
شراكة	Partnership
المعدلة	Amended
محيط	Ocean
اليك	Thee
والاستمرار	And
الكادر	Level
فكرا	Thought
العافية	Wellness
النمساوي	Austrian
بجدارة	Deservedly
التجريبي	Pilot
والشمس	The
مخافة	Fear
بأسعار	At
الادخار	Savings
يحتفظ	Retains
العمق	Depth
والقائمين	The
بقليل	Just
العزلة	Isolation
أكتب	Write
الرامي	Ramie
جسور	Bridges
ببرنامج	Program
عضويته	Membership
صون	Maintenance
المجال	Area
المحترفين	PRO
والان	Now
تستدعي	Call
الموضوعية	Objectivity
درب	Trail
اعتبرت	Considered
توماس	Thomas
اللوائح	Regulations
والحرف	And
ملكوت	Kingdom
تتسع	Accommodate
مساعدا	Assistant
الاسرية	Family
اسر	Capturing
النفاق	Hypocrisy
والتوزيع	And
معلما	Milestone
أحل	Permitted
والأمانة	The
للاهتمام	Interesting
ويأخذ	It
الكيان	Entity
صدورهم	Chests
الشجر	Trees
التشيك	Rep
لبيان	Statement
مبين	Shown
الرمضانية	Ramadan
العدوى	Infection
بالمسلمين	Muslims
تحوي	Containing
والنظام	The
البيولوجية	Biological
تعطى	Given
للقارئ	The
سداد	Pay
السقف	Ceiling
بشركة	Company
لأصحابه	To
تصوره	Conceivable
والفساد	And
ورثة	The
تستند	Based
المفيدة	Useful
ولنا	And
شهدته	Witnessed
سيرته	His
الباحثون	Researchers
واقفا	Standing
مواردها	Resources
بالجزائر	Algeria
معتمدة	Certified
أقوم	I
بيكهام	Beckham
منهجية	Methodology
الخيارات	Options
طلحة	Talha
القاص	Storyteller
تاركا	Leaving
والماء	And
يتبعها	Followed
والحق	And
استقلال	Independence
ايصال	Delivering
طاقتها	Capacity
والسودان	Sudan
كسبت	Earned
عبدالنبي	Abdulnabi
ندعو	Call
يتصدى	Address
اصابته	His
وفرق	The
النمل	Ants
فهؤلاء	Those
والإعلام	And
هند	India
اعتداء	Assaulted
الابحاث	Research
ابداع	Creativity
والظاهر	Apparently
طرأت	Occurred
التغطية	Coverage
الغرف	Room
ترفيهية	Recreational
اصوات	Votes
الحمداني	Hamdani
فيديو	Video
فصلى	Prayed
اياد	Iyad
ارى	See
وجها	Face
كلينتون	Clinton
ستشهد	Will
اوضاع	Conditions
شعوبا	Peoples
المعدنية	Mineral
متكافئة	Equal
حر	Free
التجريبية	Experimental
أدم	Adam
جوف	Goff
المكثفة	Intensive
رؤيته	See
القمح	Wheat
وتكوين	And
المتكررة	Repeated
للقلب	Heart
يدا	Hand
الكورية	Korean
والداخلية	The
يعول	Reliable
معاهد	Institutes
البلاء	Scourge
مسند	Holder
أطراف	Parties
والضعف	And
لتحرير	Liberation
كثب	Closely
الحقيقة	Truth
البلجيكي	Belgian
تطهير	Purge
عمار	Ammar
الكشفي	Scout
يشهده	Witnessed
بشراء	Buy
رائدة	Leading
قابل	Met
التدقيق	Audit
صمت	Silence
الخلف	Back
منزلة	Status
وحمدي	Hamdi
الاخبارية	News
مارسيل	Marcel
الدولارات	Dollars
أخرجه	Narrated
الامتياز	Franchise
الخليجى	Gulf
ونبذ	And
سفره	Traveling
لتشغيل	To
زمني	Time
لهم	Them
الانسان	Rights
بصحة	Health
إليكم	You
والتخلص	And
الكروج	El
الاعاقة	Disability
لعلي	Ali
نشره	Published
والهدايا	And
عينه	Eye
الفرعي	Sub
بأداء	Perform
المثلى	Optimal
الارضية	Ground
مطالبا	Calling
عاصم	Asim
الطرد	Expulsion
تتوقع	Expects
والتوفيق	And
للكشف	To
ويحيى	Yahya
ومعدات	And
سلبيات	Cons
صحوة	Awakening
اربعين	Fortieth
يحيي	Yehia
وأصحابه	And
الروائية	Novelist
فصلا	Chapter
يصير	Becomes
اعلامية	Media
جوانبها	Aspects
الشحن	Shipping
لبنة	Brick
أوتوا	Ottawa
المؤدي	Leading
بمرحلة	Phase
حكمت	Sentenced
أظن	I
ضرر	Damage
والرجل	And
يبعد	Is
كادت	Almost
العلمية	Scientific
الحقد	Hatred
فضاء	Space
اولويات	Priorities
الاياب	Leg
النقاب	Unveiled
الفاصل	Interval
الافق	Horizon
التصورات	Perceptions
بشمال	Northern
وتربية	And
المصلين	Worshipers
يصادف	Marks
شاملا	Comprehensive
جاز	Jazz
الفريدة	Unique
ريسوت	Raysut
لى	Li
خرجنا	We
وشملت	Included
وظهرت	There
هب	HP
ينقص	Missing
وفوزي	Fawzi
الأمر	It
فخ	Trap
اشبه	Like
بمنى	Mina
الاستقبال	Reception
الرقيب	Sergeant
انان	Annan
ومراقبة	And
حان	Come
والحرس	The
مشتركا	Joint
والإيمان	And
والجماعات	And
كاظم	Kazem
الكونغو	Congo
كثيرين	Many
الصاعد	Rising
المعماري	Architect
والتوعية	And
أساسيا	Key
لذلك	To
والهيئة	The
الضخم	Huge
تعادلا	Drew
وتقرير	Report
سورية	Syria
الشرسة	Fierce
للبشرية	Of
بالقضاء	Elimination
الالتقاء	Meet
والتشريعات	The
الحامل	Pregnant
أبريل	April
المتبادل	Mutual
اردنا	We
الربح	Profit
لمزيد	For
التدابير	Measures
الفحشاء	Indecency
طبيعته	Nature
الثروات	Wealth
بذات	Same
والمعروف	Known
الشيخة	Sheikha
المارينز	Marines
واتخذ	And
ويحقق	And
المنصوص	Provided
أجرى	Conducted
بنور	Light
الماجستير	Masters
احتوى	Contains
المونديال	World
مقاصد	Purposes
أثبت	Proved
الحريات	Freedoms
انصار	
وهب	Wahab
مستغلا	Exploiting
مليوني	
الخفيفة	Light
يقر	Recognizes
اعتداءات	Attacks
تهديدا	Threat
وصار	And
وضح	Explain
جبهة	Front
والروح	The
يطل	Overlooks
الشهداء	Martyrs
ثمارها	Off
تستعد	Prepares
نشرته	Published
متاحة	Code
منزلا	House
انظروا	Look
واجراءات	And
المحمية	Protected
يلتزم	Committed
والاعداد	The
والإسلامي	The
نظيفين	Straight
والخبرة	And
أيضا	Also
وفكره	The
الأديان	Religions
بالصحة	Health
القرضاوى	Qaradawi
قصارى	Every
معوقات	Constraints
الآليات	Mechanisms
سلالة	Strain
اختصاص	Jurisdiction
المشروعة	Legitimate
المنعم	Moneim
الثلاثي	Triple
الآتية	Following
سميع	Hearing
سفارة	Embassy
استعداداته	Preparations
تجسيد	Embodiment
سيقدم	Will
والتوصيات	And
الملقاة	Placed
خام	Ore
السياسيين	Politicians
الأرحام	Wombs
الربيعي	Rubaie
السابق	Previous
والموارد	And
مراحله	Stages
ملحوظة	Remarkable
السيادة	Sovereignty
والتعارف	And
خضم	Midst
الشعاب	Coral
ايمانه	His
التعليق	Comment
انباء	News
وتوثيق	And
فالمسلم	Muslim
العبث	Tampering
معالجتها	Processed
رفعها	Filed
ببلدية	Municipality
يتسبب	Cause
المذكرة	Note
سم	Cm
المعادن	Metals
تراه	See
الإخلاص	Fidelity
ونور	Noor
حركات	Movements
بكفاءة	Efficiently
بلده	His
المستحيل	Impossible
والمال	The
العناوين	Address
الشعار	Logo
الرصاص	Lead
يتأهل	Oiled
الطوقي	Ring
الاغنية	Song
ليحصل	To
والامهات	And
يؤدى	Lead
عمال	Workers
وغيرهما	The
وموسى	And
الإباضي	Ibadi
سارت	Marched
خلقكم	Created
تخصصات	Disciplines
المستهدفة	Target
التخرج	Graduation
حيز	Into
اعد	Promising
منتجاتها	Products
امتار	
الاندماج	Integration
والبعد	The
آداب	Etiquette
كلاهما	Both
محققا	Achieving
مور	Moore
لراعي	To
لإدارة	Management
والمؤمنات	Men
حاصل	Holds
والثناء	And
جونز	Jones
المبيت	B
والحكمة	And
الثقافى	Cultural
اعتمادا	Depending
مهاجمه	Striker
يتصرف	Acting
بتونس	Tunis
الكرواتي	Croatian
وتصحيح	The
الاسبوعية	Weekly
تلاوة	Recitation
الجسدية	Physical
الجنازة	Funeral
معقدة	Complex
بالكرة	Ball
الكواكب	Planets
بوصفه	As
وتبين	And
ودعوة	And
الأربعة	Four
جلاله	Majesty
مقبولة	Accepted
تنافس	Compete
نبأ	News
كفيلة	Capable
العرس	Wedding
هز	Shook
التامة	Full
سلبي	Negative
الخطير	Dangerous
معصية	Disobedience
القبور	Graves
جانبي	Side
أبدى	Showed
المراجع	References
فورا	Immediately
الترابط	Interdependence
اسقاط	Dropping
سكولاري	Scolari
اسعد	Asad
حضره	Attended
شريفي	Sharifi
الجولات	Tours
الاثارة	Excitement
جراند	Grand
وتجديد	And
الداء	Malady
الاقامة	House
للفترة	For
صفرصفر	Cefrcefr
واحتلت	And
الأجواء	Atmosphere
مستعدة	Ready
تتكرر	Repeated
البورصات	Bourses
حتمية	Inevitability
أجله	Him
يسر	Pleased
ومهمة	The
الأهالي	Parents
فك	Decoder
العريف	Corporal
امة	Nation
تأثيرها	Impact
ليسوا	Not
رأيك	Your
تجربتها	Experience
دافع	Defended
فعند	When
كيم	Kim
المحليين	Local
السيولة	Liquidity
الخاصة	Private
ريح	Wind
أذكر	Recall
عيني	Eyes
توازن	Balance
يحرك	Stir
قولها	Saying
واخر	And
الإجماع	Consensus
مقعدا	Seats
والطب	And
الرفض	Rejection
واستمرت	And
ناجحا	Successful
فالإسلام	Islam
وطلال	Talal
حضاري	Civilizational
استهدفت	Targeted
اقتراب	Approaching
الإطلاق	All
بيتي	Betty
نمت	Grew
تغذية	Feed
القارات	Continents
مالم	Unless
واردات	Imports
والمختصين	And
العريضة	Petition
علوي	Top
نظمته	Organized
اخطاء	Mistakes
تنوعت	Varied
وتعلم	And
أوتي	Oti
إنجازات	Achievements
شرطا	Prerequisite
تفسيره	Interpreted
طالبت	Demanded
الفلسطينية	Palestinian
معبرا	Conduit
واصيب	And
كبير	Large
المحامي	Lawyer
وتوضيح	And
لتطبيق	To
الكبرى	Grand
عالمنا	Our
ألسنتهم	Tongues
صادقا	Honest
انتباه	The
التلاميذ	Pupils
الأقرب	Nearest
الماضية	Past
يشكلون	Make
هارون	Aaron
واستمرار	And
العباس	Abbas
أحد	A
عرفوا	Knew
الخصخصة	Privatization
المئات	Hundreds
رامسفيلد	Rumsfeld
والشرق	And
بطون	Stomachs
يسلم	Delivers
أسابيع	Weeks
الصفحة	Page
إبليس	Satan
المنتجين	Producers
وكلاء	Agents
إسلام	Islam
والعلاقة	And
الاحتياط	Reserve
قبلة	Kiss
الغموض	Mystery
الرواد	Pioneer
ثنائية	Bilateral
مراد	Murad
مسئولي	Officials
هيكل	Structure
بالمدينة	The
فرحان	Farhan
استمرارية	Continuity
المعاهدة	Treaty
التحويلية	Manufacturing
جدية	Seriousness
السكن	Housing
وعليها	And
الخليجيين	Gulf
بروز	The
ومشاريع	And
سينما	Cinema
الوالدان	Parents
الرحيل	Leave
حظ	Fortune
يتقبل	Accept
الإلكترونية	E
والحج	The
انجازه	Accomplished
لعبها	Played
الحكاية	Tale
التقاليد	Traditions
الحصن	Fort
نكن	We
الاية	Verse
متأخرة	Late
والسياسي	And
ينتمون	From
نجاحها	Success
السجلات	Records
تنبع	Stems
الهدية	Gift
الجلوس	Sitting
القرض	Loan
أمامها	Before
أنواعها	Types
منحت	Granted
ينتشر	Spreads
الفنانات	Artists
معلمة	Parameter
ادارات	Departments
دروس	Lessons
منخفضا	Low
شل	Shell
التنقل	Mobility
المصائب	Calamities
المعادلة	Equation
الدبلوماسية	Diplomacy
اعترف	Admitted
الهاشمية	Jordan
غنية	Rich
التغير	Change
لمدينة	City
عناوين	Addresses
أبيها	Her
الثقيل	Heavy
بمساعدة	Assisted
اختلفوا	Differed
الألم	Pain
يلاقي	Find
جزئية	Partial
عاتق	Lies
الضحك	Laughter
للآخر	The
نواة	Nucleus
الرفيع	High
نشاطات	Activities
غابت	Absent
[سورة	[Sura
الزحام	Hustle
العملات	Currency
حصوله	Receiving
أصدر	Issued
وينتهي	And
الوارث	Heir
المؤثرة	Affecting
المصحف	Mus
صحتها	Correctness
الآلاف	Thousands
فرج	Faraj
البكاء	Crying
البدائل	Alternatives
تطالب	Calling
الباردة	Cold
أخطاء	Errors
الإلكتروني	E
بالدورة	Session
السهلة	Easy
مشاة	Infantry
حكمها	Rule
تصاعد	Escalation
والمقاييس	And
لاعبه	Player
الأصلية	Original
وأفضل	The
تحتضن	Embraces
للكثير	For
داره	House
وبث	Broadcast
سليما	Sliema
مداخل	Entrances
للمدرب	Coach
النادرة	Rare
الضاحية	Suburb
الأبصار	Eyes
التصحر	Desertification
حسابات	Accounts
احدهم	One
سبقه	Previous
وقتنا	And
السنوى	Annual
التيارات	Currents
تطبيقات	Applications
باستغلال	Exploiting
رابع	Fourth
مخرجات	Output
بقضايا	Issues
وهاشم	Hashim
يتلقى	Receives
لوقف	To
الفاعل	Actor
والاستعداد	And
ضالة	Stray
عينات	Samples
بالمياه	Water
قم	Then
والبناء	Building
احتفلت	Celebrated
برز	Emerged
استغلالها	Exploited
المكونات	Components
إقليم	Region
بتسديدة	Shot
بادارة	Running
ناهيك	Not
تقضي	Spend
التسوية	Settlement
فرحا	Joy
كتيبة	Battalion
بوادي	Valley
العائلات	Families
رابعة	Fourth
والجهاد	Jihad
وبينه	And
اعمالهم	Their
آله	SAW
بعشرة	Ten
يجرى	Being
ولك	You
أقام	Established
فترى	You
الارهابيين	Terrorists
المتنقل	Mobile
نزع	Disarmament
ودعت	And
خليج	Bay
بنيابة	Procuratorate
بيئية	Environmental
كثافة	Density
انتقادات	Criticism
التثقيف	Education
اتضح	Turns
الآخرة	Hereafter
الدبلوماسي	Diplomatic
مجتمعه	Combined
تستقبل	Receive
وتغيير	And
تواصلت	Continued
والخابورة	Khabourah
الثنائي	Duo
شخصيته	His
والرغبة	The
واتاحة	And
المشرع	Legislator
شدد	Stressed
بقلب	Heart
هزيمة	Defeat
أمها	Her
يضرب	Hits
الميادين	Fields
انسحاب	Withdrawal
وخمسمائة	And
والمعرض	The
يفسر	Explains
للعبة	The
المشركون	Polytheists
تنموية	Development
ينفقون	Spend
الشيزاوي	Shezawi
مؤقتة	Temporary
السوفيتي	Soviet
للنبي	The
ملكة	Queen
حصلوا	Received
المعاصرين	Contemporary
الملل	Boredom
لمواكبة	To
مرارا	Repeatedly
الديموقراطي	Democratic
ايه	AT
مستقرة	Stable
والرد	And
للتخطيط	Planning
مسجلة	Registered
ووجدت	And
الحائط	Wall
المواطنون	Citizens
لإعادة	To
لألعاب	Games
والمشرفين	And
سقطت	Fell
ينهي	End
مسلمين	Muslims
لكونها	For
للعرض	Showing
جميلا	Beautiful
والشعراء	And
بالمغرب	Morocco
المدعوين	Invitees
للاعب	The
مولى	Sire
فشيئا	Gradually
يفوق	More
عريضة	Petition
التقاط	Capture
ويا	Loya
ولاشك	Undoubtedly
الترفيه	Entertainment
والمملكة	The
فنزويلا	Venezuela
الكتيبة	Battalion
وائل	Wael
ليبقى	To
الفوضى	Chaos
دفاعا	Defense
الشبه	Similarity
الفتى	Boy
تعذر	Unable
اليأس	Despair
وخطط	And
يسيطر	Controlled
يولد	Generates
اهلها	Its
الافتاء	Ifta
الرسيل	Rusayl
وحضور	And
ثواب	Reward
مصاف	Ranks
المطالبة	Claim
الاستثماري	Investment
ترميم	Restoration
والاخير	The
ينعم	Enjoy
اكتفى	Only
ودائرة	Circle
التقيد	Adherence
واقعة	Reality
أولاده	Sons
والبنك	The
يخاف	Afraid
غنائية	Lyrical
مشاركتهم	Their
وراءه	Behind
صواريخ	Rockets
ضخم	Huge
بصدق	Honestly
ويلتقي	And
الجردانية	Jerdanih
عناء	Bother
فلسطيني	Palestinian
الأمس	Yesterday
تغييرات	Changes
مأساة	Tragedy
الاندونيسي	Indonesian
لقبه	Surnamed
الجديد	New
العمالية	Unions
متصل	Post
زائر	Visits
ايدي	Eddie
احدكم	Any
العصر	Age
الرب	Lord
امتدت	Stretched
ركلات	Kicks
مواتية	Favorable
لحساب	To
انفسكم	Yourselves
أجمعين	Wholes
بأسره	The
شهريا	Monthly
تشريع	Legislation
المحرمات	Taboo
ذاتها	Same
تكثر	Abound
زاوية	Angle
البنات	Girls
يكلف	Cost
يمينه	His
باطل	Void
الأخ	Brother
ملأ	Filled
بفوزها	Winning
عائدات	Revenues
مشيدا	Praising
عمان	Oman
قبلها	Before
ارتداء	Wear
اتمنى	I
كبر	Zoom
يحيط	Takes
والقانونية	The
معجزة	Miracle
عبدالقادر	Abdulkadir
بالله	God
ولاة	And
لنيل	Neil
تتركز	Concentrated
الاسراء	Isra
تكلم	Spoke
الوفيات	Deaths
تموت	Die
وفضل	The
الأرضي	Ground
البرزخ	Isthmus
المسافات	Distances
أسوأ	Worst
لاطلاق	To
الانتقالية	Transitional
غالب	Ghalib
قولهم	Saying
بديوان	Diwan
جسمه	Body
مناقشات	Discussions
العقاب	Punishment
سنوات	Years
للفائزين	To
تصريحه	Statement
لاقت	Received
ينظمه	Organized
اتهم	Charged
الدغيشي	Aldgesha
الأمطار	Rain
بالأمس	Yesterday
والعدل	And
النقالة	Mobile
بتدريب	Trained
وهن	They
وإدارة	And
والشعور	And
والهلال	Crescent
تكفي	Suffice
النهائي	Final
وتركيا	Turkey
الاوائل	Top
يشجع	Encourages
أهالي	People
ونزوى	Nizwa
والباقي	And
الموهبة	Talent
الامدادات	Supplies
مميزا	Distinctive
بليون	
لجذب	To
دراية	Familiar
ستار	Star
دلالات	Semantics
يستخدمها	Used
الشفاء	Healing
خاطئة	Wrong
وصحم	Saham
اباد	ISLAMABAD
صدى	Echo
بالاهتمام	Interest
بو	Bo
خالصة	Pure
حفاظا	Preserve
إزاء	About
التهديدات	Threats
الدماغ	Brain
المكاتب	Offices
أيا	Whatever
الاعدادية	Prep
مديرا	Director
سيطرته	Control
يعرفه	Know
اظهار	Show
ظهرا	Noon
بئر	Beer
نهار	Day
توافق	Agree
معارضة	Opposition
العائلية	Family
المجتمعون	Conferees
ولديه	And
مرآة	Mirror
وفهد	Fahd
سندات	Bonds
موقعا	Location
محبي	Lovers
القيامة	Resurrection
الثوب	Dress
والطلب	And
التمر	Dates
تحالف	Alliance
المطرب	Singer
الاقتراح	Proposal
الساحلي	Coastal
للاعبي	Of
ولاسيما	Especially
ضيفا	Guest
صح	True
بنفسك	Yourself
حماد	Hammad
النعمان	Numan
الميقات	Meeqaat
التخصصية	Specialized
بتنمية	Development
المعاش	Pension
فأن	The
عبداللطيف	Abdullatif
وسيف	Saif
ايمان	Iman
تحتها	Below
الاخلاق	Ethics
انضمام	Join
بقصد	Order
أمرها	Her
لسنوات	For
لكون	To
الشمسية	Solar
البلاغة	Rhetoric
لكونه	For
بمجموعة	Range
سنوي	Yearly
وسنحت	And
والصعوبات	And
سيطر	Dominated
العبارة	Gateway
الأول	First
سمعنا	Heard
مزارع	Farms
التنبيه	Alert
الوكلاء	Agents
وثلاث	And
الطبيعى	Natural
التحضير	Preparation
الصدقة	Charity
التقاعد	Retirement
وقيام	And
مسلحة	Armed
الامية	Illiteracy
للتمريض	Nursing
المستهدف	Target
الوفاة	Death
منشآت	Installations
قاعات	Halls
ونادي	Club
بالمدارس	School
خطابه	His
الأدباء	Writers
موهبة	Talent
خصيصا	Specifically
الشياطين	Devils
الشون	Barns
القياسية	Standard
اهميتها	Significance
الاجل	Term
لاعبينا	Our
المطهرة	Aseptic
ليكونوا	To
وإخراج	The
أوامر	Orders
اميركيون	US
بالطرق	Means
يلحق	Appends
ملكا	King
لجهود	The
بلى	Yes
بالتقوى	Piety
ضيقا	Narrow
جثة	Corpse
وصقل	And
أخبر	Tell
أياما	Days
ستشارك	Will
واد	Wade
التهديد	Threat
رأيي	My
الصناعى	Industrial
عزوجل	Almighty
بينت	Showed
الوساطة	Mediation
يخاطب	Address
التعارف	Dating
ومختلف	And
والجوائز	The
النصيحة	Advice
حبيل	Hubail
الضارة	Harmful
تلاه	Followed
ورسم	And
امرا	Ordered
أظهرت	Showed
والمشاكل	And
الاستطلاع	Poll
الاستئذان	Authorization
يسعون	Seeking
نقلت	Flew
صدقة	Charity
لنهائيات	Finals
بصوت	Voice
يتوجب	Have
المتاحف	Museums
توثيق	Documenting
نستفيد	BENEFIT
القاعة	Hall
تتطور	Evolve
الخلل	Imbalance
أردنا	We
الأصيلة	Authentic
صاحبات	Owners
طبيعتها	Nature
وتلعب	And
اجتمع	Met
الرأسمالي	VC
هنري	Henry
المسؤولة	Responsible
والتراث	And
والتقنيات	And
للحركة	Movement
امسية	Evening
رعايته	Sponsored
المظاهر	Manifestations
السلام	Peace
والمراجع	References
أسرع	Fastest
حضورها	Presence
عمارة	Building
اعتقلت	Arrested
متقدما	Advanced
قانونا	Law
والوحدة	And
حلبة	Circuit
الاسبق	Former
المعجزة	Miracle
لاكتشاف	To
وصفها	And
معلومة	Information
العماني	Oman
مواعيد	Dates
للصحة	Health
يأتون	Come
يفصل	Separates
والتليفزيون	TV
الوقائية	Preventive
انفجرت	Exploded
بالمشروع	Project
الاستمتاع	Enjoy
فهمي	Fahmi
نطالب	Call
انجلوس	Angeles
الليبي	Libyan
الانسانى	Humanitarian
بأنك	You
لسنة	For
غينيا	Guinea
واهتمام	And
السكر	Sugar
تحركات	Movements
المطلب	Muttalib
والمسرح	The
الكثافة	Density
وانهم	And
موقعه	Its
المتعلق	On
احتساب	Calculating
مقرر	Decision
التشريق	Tashreeq
تسبح	Swim
الحمى	Fever
بالشرقية	Sharqia
الستينيات	Sixties
أثرت	Affected
النائية	Remote
الراعية	Sponsoring
المعصية	Sin
بدأنا	Started
القصصية	Anecdotal
الأفق	Horizon
ماجه	Majah
يلجأ	Resort
لتغطية	To
والطلبة	And
موجه	Prompt
الانطلاق	Starting
والجهاز	The
بتسجيل	Record
للغة	Language
والمنتجات	And
واللقاءات	And
آمال	Hopes
مستلزمات	Supplies
بنتائج	The
سينا	Senna
اخرى	Another
مواضع	Positions
الشجرة	Tree
تداولا	Traded
اصابات	Injuries
الأولمبياد	Olympics
للفكر	Think
ويملك	And
الدؤوب	Hardworking
للآخرين	Others
الممارسة	Practice
الميلادي	AD
صبري	Sabri
الفريضة	DUTY
وتأمل	And
ووقف	The
بهدوء	Quietly
الامكانات	Potential
الانتفاع	Use
اللذان	Two
فتحي	Fathi
مستمرا	Continuous
طفلك	Baby
وتوفر	And
تأسست	Founded
العامة	General
المعارك	Battles
كفر	Kafr
المطعني	المطعني
لرسول	Messenger
بيانا	Statement
النمط	Style
والاشراف	And
ومحافظة	The
الصيانة	Maintenance
الكلباني	Kalbani
وإنشاء	And
تمسك	Stuck
بورتو	Porto
باتحاد	Union
وتنوع	And
بمهرجان	Festival
وتقوية	And
والايمان	And
بالتعليم	Education
الشروع	Begin
يلبس	Wears
الأربع	Four
بأمور	Matters
ونسبة	The
داعي	Need
استئناف	Resume
تنظيف	Cleaning
وباكستان	Pakistan
المستفيدين	Beneficiaries
وللأسف	Unfortunately
ملة	Religion
الفروع	Branches
الأبحاث	Research
ملابس	Clothes
حريصا	Harissa
للرماية	Shooting
وضعية	Position
النطق	Speech
بالجمهورية	Republic
يغلب	Predominantly
نارا	Nara
يلعبون	Playing
ومصادر	The
شفاء	Healing
فيهن	Therein
روحا	Spirit
الضوابط	Controls
وانتهت	And
وحمل	Download
متخصص	Specialist
وتنتهي	And
نيقوسيا	Nicosia
الموصى	Recommended
يقسم	Divides
صريح	Frank
لموضوع	Multi
أصغر	Smaller
قصائده	Poems
المكونة	Constituent
محالة	Inevitably
قناعة	Convinced
النثر	Prose
سنوية	Annual
للمؤسسات	Institutions
مكانتها	Its
النجف	Najaf
خلفا	Replacing
وصلة	Link
لمعالي	HE
الحملات	Campaigns
يتراوح	Range
حكومات	Governments
بدايتها	Beginning
يارسول	Oh
توجيهات	Guidance
معشر	O
والأدب	Literature
النباتية	Plant
للدين	Of
الفقرة	Paragraph
حلمي	Helmi
صوب	Towards
مفصل	Detailed
التعويض	Compensation
بالداخلية	Boarding
الشماخي	Shammakhi
ابعدها	Drifted
والرواية	The
وحرم	The
الانتقادات	Criticism
انتخاب	Elect
بالكتاب	Book
الداعي	Calling
المصنع	Factory
يطبق	Applied
تستغرق	Takes
الثغرات	Gaps
للبرنامج	Program
والتفاعل	And
الحسين	Hussein
التجميل	Beauty
ثلاثا	Three
ومثيرة	The
السنيدي	Sunaidi
تمثله	Represents
التفجيرات	Blasts
استخدامه	Use
والحيوانية	Animal
المحافظين	Conservative
والتعليمية	And
وغياب	And
بالسنة	Year
الملفات	Files
ويبحث	Looking
ووسط	And
والجدير	It
لقمة	Summit
المؤدية	Leading
ضمنها	Including
الفهدي	Fahdi
مسؤولي	Officials
المؤمنين	Believers
يراها	Sees
سنه	Age
المقيمين	Residents
والخلق	Creation
والبيانات	The
الراعي	Shepherd
يأكلون	Ate
المصطفى	Mustafa
فيقولون	Say
الأسهم	Shares
وحده	Alone
يخلق	Creates
ينطق	Utters
الازرق	Blue
لديك	You
كلثوم	Kulthum
وشاركت	And
الفرسان	Knights
المتحركة	Moving
الكمية	Volume
ومربي	The
منهن	Of
بديلا	Substitute
الفصيح	Eloquent
الطارئة	Emergency
الألمانية	German
عملنا	Our
شهيدا	Martyr
الرعد	Thunder
المكانة	Position
وذوي	And
لاكثر	For
يومنا	Day
التفرقة	Segregation
والتأمل	And
انفسنا	Ourselves
ملاحظات	Notes
رمال	Sands
نبيلة	Nabila
وراشد	Rashid
ايضا	Also
اعرف	Know
امثال	Proverbs
الباقية	The
جبران	Gibran
جيمس	James
المسلحين	Insurgents
التعرض	Exposure
ونبيل	Nabil
ابنته	Daughter
حاولوا	Tried
بالمجلس	Council
ايرادات	Revenue
فعلينا	We
يرسم	Draws
عائد	Yield
حاكم	Governor
انابيب	Pipeline
الابن	Son
بأمر	Order
مرضه	Illness
أموالهم	Money
الموز	Banana
طبقات	Layers
وثلاثين	Thirty
تبديل	Switch
الانتفاضة	Intifada
انتقد	Criticized
الاكراد	Kurds
ازدياد	Increased
البدن	Hull
مقرا	Based
اختتم	Concluded
الثمانينيات	Eighties
الحصار	Blockade
بشرطة	Police
للهوكي	Hockey
بالليل	Night
موجهة	Directed
وظيفته	His
يهود	Jews
البقر	Cow
الهيكل	Structure
مسلمة	Muslim
التدين	Religiosity
المعروضات	Exhibits
والقضايا	And
النبيين	Prophets
حققتها	Achieved
لآيات	Signs
يعالج	Handles
تفجير	Bombing
تقوى	Piety
ويتحدث	And
والمنشآت	And
المستلزمات	Supplies
متمثلة	Represented
بارتفاع	Up
ركعتين	Rak'ahs
الجمهوري	Republican
باختيار	Choose
الحظر	Ban
ومكتب	Office
التذاكر	Tickets
والخير	And
للبنك	Bank
الكعبي	Kaabi
ماريا	Maria
الصحوة	Awakening
واعتمد	And
روايات	Novels
للإمام	Imam
بدأوا	Started
ادم	Adam
وطرح	Put
بالحركة	Movement
نشاطا	Active
الخيار	Option
نظيف	Clean
ايمن	Ayman
ترغب	Wish
العضلات	Muscle
البنزين	Gasoline
يتكلم	Speaks
الاب	Father
بحقوق	Rights
هجوما	Attack
تصنيع	Manufacturing
عبارات	Phrases
وممارسة	And
العرقية	Ethnic
بالجمعية	Assembly
مقربة	Close
عادية	Normal
وبالتعاون	And
أشجار	Trees
للعب	To
المعنوي	Moral
الزائرين	Visitors
توني	Tony
وأنثى	Female
فصلت	Separated
متقدم	Advanced
للحوار	Dialogue
وبها	And
عنف	Violence
الإلهية	Divine
توضع	Placed
يسار	Left
نسخ	Copy
التكنولوجي	Technological
السلوكيات	Behaviors
والامن	Security
التقديرات	Estimates
اسفرت	Resulted
الأمهات	Mothers
المبيعات	Sales
وتظهر	Show
والحزن	And
الأذى	Harm
نشيد	Commend
طيبا	Good
جهودهم	Their
الأخلاقية	Ethical
ازداد	Increased
وتعيين	And
الحبيبة	Beloved
التساؤل	Question
المهاجمين	Attackers
الفقيرة	Poor
منصة	Platform
مساندة	Support
آلام	Pain
وتقع	Located
أبت	ABT
الخصوصية	Privacy
والسؤال	The
اخوانه	Brothers
تغيرات	Changes
المساندة	Support
يقم	Have
ننتظر	Wait
جسده	His
الانخفاض	Drop
ن	N
لأبناء	For
تجعله	Make
باع	Sold
تساؤلات	Questions
القافلة	Caravan
التعذيب	Torture
الخاص	Special
الاصلية	Original
معظمهم	Mostly
وبنسبة	And
والقدرات	Capacity
بحجم	Size
البشرية	Human
دونه	Below
الذكرى	Anniversary
تحرم	Denied
أرجاء	Around
بتشكيل	Formation
تحكيم	Arbitration
التليفزيوني	TV
الحفلات	Concerts
والثقة	And
التشجيع	Encouragement
حضوره	Attending
والفرص	And
للشعر	Hair
بالقوة	Force
وأداء	And
والافراد	And
موناكو	Monaco
وعادل	And
المحللين	Analysts
العواطف	Emotions
لتغيير	To
مطلقة	Absolute
وتوجد	There
القتلى	Dead
ولايتي	Velayati
باختلاف	Different
مكاسب	Gains
استطيع	I
وتجدر	It
للقانون	Law
وغيرها	The
ثوابت	Constants
السكون	Sleep
لفريقه	To
تطرقت	Touched
الغربة	Alienation
صعود	Rise
ترشيح	Nomination
اصدر	Issued
الصالحات	Righteousness
مرضية	Satisfactory
الصلب	Steel
والتقوى	And
الموظف	Employee
فساد	Corruption
للاسلام	Islam
بالمجمع	Complex
أيدينا	Our
برامجها	Programs
الوهاب	Wahab
جارية	Ongoing
يغطي	Covers
انفرد	Himself
خالق	Creator
اتهام	Charge
يواجهها	Faced
استبعاد	Excluding
تقدما	Progress
زمزم	Zamzam
مطلب	Demand
الاستعمار	Colonialism
وسلطان	The
وتدور	And
والسياسة	And
البصرية	Optical
وصلاح	Salah
الصبح	Waxing
لرجال	Men
أشعر	I
نافذة	Window
انس	Lance
واعمال	Acts
والرشداء	And
وأحد	And
وجوههم	Faces
المقارنة	Comparison
بارك	Park
الاستماع	Listen
وتاريخ	And
قرآنا	Quran
والنبي	The
المربي	Educator
والدراسة	The
تلو	After
الفجوة	Gap
والنتائج	Results
ووفقا	According
ولدي	I
السائقين	Drivers
متعلقة	Related
ومواقف	And
الرقمية	Digital
وليبيا	Libya
الخضوع	Undergo
سلعة	Commodity
وابراز	The
ترفض	Rejects
شهرة	Fame
خالصا	Pure
ومستوى	And
الأنصار	Ansar
يغني	Sing
أقوال	Sayings
تختتم	Conclude
والآثار	The
تهدد	Threaten
وحذر	And
بالعودة	Return
اختلافا	Difference
تدمير	Destroying
والاهداف	And
وجعله	And
يجسد	Captures
وتتميز	Featuring
العقيد	Colonel
يستهدف	Targets
اجرى	Conducted
النزول	Down
الناعبي	Naobei
اتجاهات	Trends
تذاكر	Tickets
وزارات	Ministries
إزالة	Remove
المقاولين	Contractors
اظهر	Showed
أمرهم	Ordered
هداية	Hidayat
حاسمة	Decisive
التعصب	Intolerance
المعبرة	Expressive
الإيجابية	Positive
المخصص	Allocated
وقائع	Chronicle
شغل	Served
ليخرج	To
سعت	Sought
وحقيقة	The
عسى	Perhaps
الأولي	Initial
المفروض	Imposed
يحتاجه	Needs
مبرر	Justification
بورنومو	Purnomo
رمزا	Symbol
مشابهة	Similar
ليفربول	Liverpool
صناعات	Industries
أمكن	Possible
قياسية	Record
بطلب	Request
وهلال	Helal
التفريط	Alienate
حجمها	Size
حرجا	Critical
جنس	Sex
الاضرار	Damage
التحدث	Talk
قنبلة	Bomb
الفهد	Leopard
المقاييس	Metrology
تعويض	Compensation
ارقام	Numbers
افاد	Reported
وثائق	Documents
توقعات	Expectations
والنمو	And
الغريب	Strange
الاسد	Assad
اكون	Be
السادات	Sadat
للسباحة	Pool
بالإسلام	Islam
اجمالية	Total
أشخاص	People
وتبدأ	And
المركزى	Central
جمعاء	Whole
حملات	Campaigns
الشيباني	Shaibani
سبعين	Seventieth
تشخيص	Diagnosis
الفلك	Astronomy
المحرم	Muharram
فأصبح	Became
اسحاق	Isaac
يمين	Right
العود	Oud
وجهك	Face
بالمجتمع	Community
فأولئك	Those
الطبقة	Class
كلف	Cost
مقترحات	Proposals
بالبيت	House
التعديل	Amendment
قتلت	Killed
الانظار	Catching
بشار	Bashar
صورته	Image
والاسلامية	The
طالبة	Student
تقليدية	Traditional
وشراء	And
غني	Needless
المساهمين	Shareholders
وإقامة	And
تعتقد	Think
يليه	Followed
تر	See
فيليب	Philip
والحكومة	Government
الأديب	Writer
وثلاثة	And
يتحدثون	Talking
ومسابقات	And
اختلفت	Differed
والسنة	The
والاقليمية	And
ويتناول	Addresses
أتت	Brought
وحكم	And
سور	Wall
تنشأ	Arise
وتحديث	The
دقيقا	Accurate
ميل	Mi
مساجد	Mosques
قدير	Kadeer
بابا	Baba
اشكر	Thank
قانوني	Legal
الموسوعة	Encyclopedia
بعدهم	After
فيلمه	His
الفرع	Section
ترشيد	Rationalization
عبدا	Slave
المبكرة	Early
وتشكيل	And
الشهرية	Monthly
أعلام	Flags
بقول	Bean
بموضوع	Issue
وبينما	While
قوته	Measuring
الآتي	Following
الشواطئ	Beaches
مميز	Join
نصت	Provided
المقيم	Resident
التصنيف	Category
انهما	They
السوداء	Black
والنفس	Psychology
اغتيال	Killing
والحيوان	Animal
ستين	Sixtieth
وغرس	And
الولاء	Loyalty
الروماني	Roman
النيجيري	Nigerian
نضع	Put
الالي	Automatic
المحمدية	Muhammadiyah
يتأتى	Come
تكفل	Ensure
اخرج	Exit
الاصولية	Fundamentalism
لاحد	One
حاجات	Needs
أجريت	Conducted
وخير	The
اهدافها	Targets
والمروة	Marwa
تعين	Appoints
حالته	His
يكثر	Lot
ونحو	And
العملاق	Giant
صوم	Fast
وروسيا	And
تلتها	Followed
فكانوا	They
الكامنة	Underlying
التساؤلات	Questions
والمعارف	And
ووجه	And
الأواخر	Days
ازكي	With
نخل	Sift
تستطع	Unable
الغياب	Absence
انزل	Down
وقفت	Stood
وعيسى	Isa
النفس	Psychology
تفهم	Understand
الفلبين	Philippines
تشغل	Operates
بتهمة	Charges
ووادي	Valley
الاجمالى	Total
الاحاديث	Chatter
أساسي	Basic
للبلاد	The
الرأسمالية	Capitalism
لعلهم	They
المعرفية	Cognitive
ولدت	Generated
والاجنبية	Foreign
للمجموعة	Group
الهولندية	Dutch
نيستلروي	Nistelrooy
باليوم	Day
ممثلا	Representing
نعتقد	Believe
داعيا	Calling
والدولي	The
الجبهة	Front
والمساعدة	And
تروسييه	Troussier
مضت	Ago
المجتمع	Community
تأدية	Perform
يمارس	Exercises
والمستوى	Level
الجنسي	Sexual
وثانيا	Second
قلعة	Castle
هدم	Demolition
نجده	Found
فينبغي	Should
حافزا	Catalyst
الاغاني	Songs
الخصم	Discount
بأربعة	Four
يستغرق	Takes
قاضيا	Judge
المرجح	Likely
ويتكون	And
والحرص	And
والقرى	And
الأسماء	Names
غنيم	Ghoneim
للعقل	Of
جدران	Walls
للمساعدة	To
عنهم	Their
يجدوا	Find
امه	His
الكيماوية	Chemical
القصور	Palaces
مخيم	Camp
ذكرنا	Mentioned
المسافرين	Travelers
بالبيئة	Environment
ور	War
الميداني	Field
انقطاع	Interruption
اللؤلؤ	Pearl
تسقط	Down
السعيدي	Saidi
جئنا	Came
والجهد	And
نظمها	Organized
منتج	Product
المقابل	Turn
مستواها	Level
ويقدر	An
ورجل	The
القويم	True
وقدرة	And
وتشهد	The
الاكتفاء	Sufficiency
فانهم	They
الممكنة	Possible
فاعلية	Effectiveness
تحريم	Prohibition
واحترام	And
تمييز	Discrimination
الحلق	Throat
وسهولة	And
للأمم	Nations
تواجهها	Faced
الاقسام	Sections
ثقافيا	Culturally
بدليل	Guide
دعوى	Case
التفاوض	Negotiating
ونعم	Yes
المشرفين	Supervisors
رائحة	Smell
الاستغلال	Exploitation
نصير	Naseer
يهدد	Threatens
وصلوا	Reached
سماحته	Eminence
منازلهم	Homes
الطائي	Tai
الأعراف	Norms
تلوث	Pollution
ونساء	And
حضارية	Civilized
يصدق	Incredible
الظل	Shadow
سيعمل	Will
وإيجاد	And
للنفس	For
والحضارة	And
متاع	Chattel
شق	Incision
صراط	Path
المناسك	Rites
عوف	Auf
لكني	I
تحتل	Occupies
الأرقام	Numbers
شكره	Thanked
تليفزيون	TV
التغييرات	Changes
الغذائي	Food
يتعدى	Exceed
واتمنى	And
نعم	Yes
مبلغا	Amount
الانبياء	Prophets
جنديا	Soldier
لتلبية	To
وأعرب	The
روبرت	Robert
يصب	Hurt
واللاعبين	The
ويصبح	Becomes
وكلمة	The
ادوات	Tools
التأثر	Vulnerability
صلب	Steel
الأسد	Assad
الانطلاقة	Breakthrough
الطقس	Weather
تقديرا	Estimate
يروي	Leroy
الخالد	Immortal
تتوافر	Available
الحميدة	Offices
للسكان	Population
الراوي	Rawi
لاجل	To
لاداء	To
لعمليات	Operations
أبصارهم	Eyes
لظروف	Conditions
الطعن	Appeal
ماهو	What
المفروضة	Imposed
فيك	Vic
والفني	Technical
اليتامى	Orphans
الفطرية	Fungal
الاسلاميين	Islamists
الاخرة	Hereafter
ويعقوب	And
الدفاعي	Defensive
وكثير	Many
والمحبة	And
الاتهام	Charged
البائع	Seller
العلقة	Hirudo
وعملية	The
نادر	Nader
النار	Fire
أمي	Mom
يتسع	Accommodates
وزيرة	Secretary
بالنجاح	Successful
وتهيئة	And
بالجانب	Side
هاجر	Hagar
الامهات	Mothers
التجويد	Tajweed
الايدز	AIDS
وأحسن	The
الحقول	Fields
وجبة	Meal
المفاجآت	Surprises
دفعت	Paid
البريدية	Mailing
كثيرة	Many
منتدى	Forum
اثراء	Enrich
الجوع	Hunger
هدي	Hoda
جولات	Rounds
محاضرته	Lecture
لأهل	To
خطرة	Dangerous
كاف	K
الآفاق	Prospects
اثبتت	Proved
أعقاب	Following
حقيقيا	Real
قبائل	Tribes
احتلت	Occupied
ممتازة	Excellent
تشرف	Oversees
تخلف	Retardation
كفة	Cuff
يفضل	Preferably
وأميركا	America
التكرار	Iteration
مستقبلية	Future
غيره	Other
والحرية	The
وفرت	Provided
الهائلة	Massive
السناني	Sinani
ونفس	The
تضيع	Lost
للمشاريع	Projects
لتمويل	To
زيمبابوي	Zimbabwe
بحثه	Examined
الصديقة	Friendly
يشرب	Drink
الزمنية	Time
والشراب	And
والحركة	The
إياه	Him
المخطط	Planned
التمهيدية	Pre
نحقق	Achieve
تدعيم	Consolidate
للاسكان	Housing
طموح	Ambitious
دينكم	Religion
حسنا	Well
بالمعنى	Sense
قطعت	Cut
الجنائية	Criminal
وأبي	Abi
تتأثر	Affected
الديانات	Religions
تصنع	Made
ويحمل	And
بإقامة	Establishment
وزاد	Increased
ود	Wad
وسخر	And
نحتاج	We
المناقصات	Tenders
الكرامة	Dignity
لمجرد	Just
خلقناكم	We
سفن	Ships
يفعله	Do
النشاطات	Activities
موضوعا	Issue
الاحتياطي	Reserve
فرح	Farah
وحيدا	Lonely
جهله	Ignorance
واجه	Faced
الاسماعيلي	Ismaili
رواسي	On
لمشاهدة	View
سيعقد	Held
أوضاع	Conditions
الكثيري	Alkatiri
بدايات	Beginnings
المتعة	Fun
تخفيف	Ease
المسمى	Title
والعكس	And
للفرد	Per
اقام	Established
مارك	Marc
فوزها	Winning
السيستاني	Sistani
بالخدمات	Services
هوبيس	Hubes
وإنه	It
المشي	Walking
والمرافق	And
تفجيرات	Blasts
قادرين	Able
أشواط	Runs
والمعلمات	And
بوابة	Gate
للمعلومات	Information
تاريخيا	Historically
عراقيين	Iraqis
تيار	Stream
واجهت	Faced
قدمته	Submitted
أشأ	Asha
وسليمان	And
طالبات	Students
النخبة	Elite
نصل	Reach
تغيرت	Changed
العبارات	Phrases
الأزمات	Crisis
حصص	Quotas
ازاء	About
بدت	Seemed
المنافذ	Ports
الحبل	Cord
أطفال	Children
تاريخي	Historic
نظرنا	Our
والسرور	And
فذكر	Recalled
والكتابة	And
بكتاب	Book
شهداء	Martyrs
ابعد	Beyond
الشامسي	Shamsi
للاستثمارات	Investments
السلبيات	Negatives
منتخبا	Elected
جماعية	Collective
وخلق	And
ونظم	And
مخطط	Scheme
وتضمن	And
وتطور	And
السياحى	Tourism
الضحايا	Victims
الروابط	Links
الإنجازات	Achievements
نشطة	Active
محللون	Analysts
الأزمة	Crisis
فردية	Individual
مكونة	Composed
العسكريين	Military
المفاجأة	Surprise
المخرجين	Directors
حياته	His
نقله	Transferred
جسر	Bridge
الادنى	Near
بقاع	Parts
اريد	I
التوجهات	Trends
وقانون	Code
المناقشات	Discussions
انهى	Finished
التوقف	Stop
مضمون	Guaranteed
النظري	Theoretical
تنمو	Grow
وإعادة	And
فلك	Orbit
مختلفا	Different
إنجاح	The
الاصلاحات	Reforms
قمت	You
المنافس	Rival
يكمل	Completes
والفن	And
تستحق	Worth
لشيء	For
قياسيا	Record
وبالتالى	And
ازالة	Removing
يغادر	Leave
المقاولات	Contracting
فرضت	Imposed
طعام	Food
التقليل	Reduce
والعربي	Arab
باتخاذ	Take
وافراد	And
تقي	Taki
مضاعفة	Double
البطالة	Unemployment
والاداري	And
أصلا	Originally
الإلهي	Divine
الاقتصاديين	Economist
الهجومية	Offensive
لنفسها	For
استطعنا	We
طلبا	Request
لاعبوه	The
الحياء	Modesty
زعماء	Leaders
وانتهاء	And
الاوروبى	European
انعدام	Lack
مسلما	Muslim
يصيب	Infects
القدير	Qadeer
احتل	Ranked
صلوات	Prayers
والدعوة	And
ثقته	Confidence
حينئذ	Then
جاهدا	Hard
العاطفي	Emotional
وأنهم	And
لاحراز	To
المثالي	Perfect
يملأ	Fills
الأصوات	Vote
المخضرم	Veteran
اغلق	Close
عودته	Returning
لابناء	Sons
منافذ	Ports
الوالي	Viceroy
للعالمين	The
ضروري	Necessary
الأعوام	Past
الأمير	Prince
الزمالك	Zamalek
التقصير	Default
تقيمها	Evaluated
أجنبية	Foreign
يستعد	Prepares
يعترف	Admits
ستقدم	Will
أكل	Eat
صغيرا	Small
عالما	World
تدرس	Studied
وتعدد	The
الغربيين	Western
الدقيقتين	Scored
بقايا	Residue
عصره	His
انعكس	Reflected
اصيب	Wounded
الاقليم	Region
إثارة	Raise
بوتين	Putin
التخلي	Abandon
والابتعاد	And
النداء	Call
بمبنى	Building
يهم	Matter
الملاحظات	Notes
إظهار	Show
المعاق	Disabled
وإذ	Taking
اظهرت	Showed
السلم	Peace
الخصيبي	Khusaibi
الأوسكار	Oscar
اوسع	Wider
وانت	You
وجعلنا	And
للموسيقى	Music
للوزارة	Ministry
المراجعة	Review
الاسنان	Teeth
الاستقلال	Independence
الصهيونية	Zionism
بوحسن	Bu
لفت	Drew
أرسل	Email
عنصرا	Element
والأخلاق	And
والشراء	Buying
بالناس	People
وجائزة	The
لعباده	Slaves
المتقين	Pious
وتعرض	And
الثوابت	Constants
والنصر	Victory
المتزايدة	Growing
الكروية	Spherical
حملها	Carry
استغل	Used
الإعلامي	Media
اعدت	Prepared
تعريفية	Tariff
السيناريو	Scenario
المداخل	Entrances
بالعربية	AF
تمديد	Extension
الاسكندرية	Alexandria
ولكني	But
منهجا	Approach
واجراء	And
النهي	Forbidding
الاعتقاد	Belief
فلج	Falaj
للدوري	League
بمكان	Place
تطبيقه	Applied
لآخر	The
اللبان	Frankincense
للمستقبل	For
الموجه	Directed
هندسة	Engineering
الثلاثين	Thirty
ومضى	The
تعداد	Census
اتى	Came
امتحانات	Exams
والحد	And
استطاعوا	Managed
ميثاق	Charter
لشبونة	Lisbon
استضافتها	Hosted
حكمه	His
جدارة	Worthiness
بقسم	Section
شئت	You
الاجواء	Atmospherics
اختياره	Chosen
ووجد	And
يقتضي	Requires
عصام	Essam
تشبه	Like
مخالف	Abuse
إرادة	Will
الحاصلة	Winning
متفق	Agreed
الاجازة	Leave
والتقنية	And
والمعاهد	And
ويأمل	And
الملايين	Millions
وعروض	Offers
فعليا	Actually
يحول	Turns
والحوار	And
ضحايا	Victims
دعما	Support
سلوكه	Behavior
النخلة	Palm
سراح	Release
أداة	Tool
التبرع	Donate
الاسس	Foundations
البريكي	Buraiki
والصحية	And
شاشة	Screen
اساسا	Essentially
خاض	Fought
اثبت	Proved
لطلاب	Students
التربويين	Educators
بلاء	Scourge
اقرأ	Read
أثبتت	Proved
نبدأ	Begin
الزبائن	Customers
وتميز	The
الشهرة	Fame
بيتا	Beta
والدين	And
المشهورة	Famous
البول	Urine
انتشرت	Spread
ارضية	Ground
قلبي	My
اكتمال	Completed
بالعراق	Iraq
كافيا	Enough
الصراط	Path
الصياد	Hunter
يتابع	Follow
وانتهى	And
بضعة	Few
المؤثرات	Effects
الاحتفالات	Celebrations
الموسيقي	Music
حملته	His
ثمينة	Precious
توعوية	Awareness
لحركة	Movement
حصد	Harvested
لكثير	For
وحينما	When
والسبب	The
بدعوة	Call
مصانع	Factories
وغالبا	Often
جهته	Part
غضون	Within
بغرفة	Room
الشقصي	Shaksy
لقانون	Law
نواحي	Aspects
البرلمانية	Parliamentary
ونال	And
المرشحة	Candidate
سنحت	Had
الفلج	Falaj
تعالي	Come
الغش	Fraud
الصفوف	Rows
لتشمل	To
مقدم	Provider
والبحر	And
والمشاركين	The
دماء	The
للسلام	Peace
ننظر	Look
امدادات	Supplies
وفن	Art
الأدوات	Tools
الفيدرالي	Federal
أهدافه	Objectives
حادثة	Incident
حصيلة	Toll
ويشتمل	Includes
صادقة	Honest
الرؤى	Visions
مقدار	Amount
أبرزها	Most
ومناشط	And
اجريت	Conducted
سموه	HH
السكري	Diabetes
الدخان	Smoke
الحليم	Halim
الايرادات	Revenue
نشعر	Feel
يلفت	Draws
سيلعب	Play
المتصدر	Leaders
المرجع	Ref
الأهل	Parents
الجمالية	Aesthetic
الاوقات	Times
والجمهور	And
يعتقدون	Believe
الاهم	The
الحراصي	Harrasi
النفايات	Waste
احرص	Accumulate
والشرب	And
وخميس	And
باحث	Researcher
ما	What
وافضل	The
الطيبات	Tayebat
_	_
عقلية	Mentality
الفيروس	Virus
فجاء	Came
سيادة	Rule
نجاحه	Success
أخر	Another
واجتماعية	And
سينمائية	Cinematic
فقراء	Poor
يتجه	Heading
الخطيرة	Serious
حفر	Drilling
التذكارية	Memorial
مقاعد	Seats
بمرض	Disease
لمحافظة	To
العدوان	Aggression
الفيدرالية	Federal
الاباء	Fathers
الزينة	Ornamental
المتفق	Agreed
ضمير	Conscience
واستطرد	And
التحصيل	Collection
وتحليل	The
الكوميديا	Comedy
الاصابات	Injuries
خلل	Defect
متواصل	Continuous
مستهيل	Mustahil
بنود	Items
العقوبة	Punishment
والعديد	And
مظلة	Umbrella
لاحق	Later
إنسانا	Man
صورا	Pictures
سيناريو	Scenario
آثينا	Athens
خامسا	V
سنين	Years
حسني	Hosni
يضر	Hurt
يرغبون	Wish
الإنجاز	Achievement
النصح	Advice
اتاحة	Allow
للشاعر	The
عاليا	High
خطير	Seriously
المصاب	Infected
القبر	Grave
والنفسية	And
والصناعية	And
نقف	Stand
والنقل	And
الملحة	Pressing
والتخطيط	And
هموم	Concerns
قدرتها	Its
يقلل	Reduces
الغنم	Sheep
ورق	Paper
بشر	Preached
الغنية	Rich
استحسان	Approbation
سرطان	Cancer
السجون	Prisons
اخيرا	Finally
الأنظمة	Systems
اهلي	Ahli
المذكور	Mentioned
ومتنوعة	Range
للكاتب	Starter
الصحيحين	Saheehayn
جمالية	Aesthetic
لطلبة	Students
الائتمان	Credit
قبلهم	Them
المغاربة	Moroccans
بقراءة	Read
القصر	Palace
الديار	Diar
الادوات	Gadgets
حيوية	Vital
معسكرات	Camps
والأمر	It
انخفاضا	Down
آمين	Amen
و99	And
بارزة	Prominent
بحري	Nautical
تحمله	Afford
والجمارك	Customs
تتحرك	Moving
تجاوزت	Exceeded
وجب	Shall
تحديدا	Specifically
واعلم	I
الموضوعة	Set
ضوابط	Permissions
اولمبية	Olympic
بأحد	One
معسكره	Camping
التجمعات	Gatherings
الخالدة	Eternal
مليئة	Filled
المفسرين	Commentators
البعيدة	Distant
التفكر	Reasoning
حقيقته	Reality
الصينى	Chinese
ويدعو	And
وتمثل	The
عيون	Eyes
والأمن	Security
المعدل	Average
وأعتقد	I
اليورانيوم	Uranium
نقلا	Quoting
والهجن	Camel
اغنية	Song
حظي	Received
والسلوك	And
بكثرة	Lot
المعنوية	Moral
المتهمين	Defendants
النبوة	Prophecy
بخيت	Bakheet
تخطي	Skip
مشاركا	Participants
النحت	Sculpture
الحارة	Hot
والأفكار	And
ووزير	Minister
ساحل	Coast
ومسقط	Muscat
أرضه	Home
التحرك	Move
انجازا	Achievement
الصديقين	Friendly
عداء	Runner
الأكاديمية	Academy
نسيج	Fabric
الفصول	Chapters
مصداقا	Illustration
أثرا	Impact
أدوات	Tools
براءة	Patent
والتأكيد	The
كلغ	Kg
تعترض	Object
الزاهر	Zaher
عدل	Edit
أمته	Nation
واخذ	And
فكره	Idea
احتمالات	Prospects
غزو	Invasion
وجعلها	And
الشدة	Intensity
رآه	Saw
أصاب	Hit
الوراثية	Genetic
النعمة	Grace
آي	Aye
مجرى	Stream
جي	LG
لبس	Unequivocally
يحاولون	Trying
الوزارية	Ministerial
المطاف	Up
فضله	Bounty
تدرك	Realize
الحاصل	Winning
مقدمتهم	Topped
تايمز	Times
وتوقع	The
يستغل	Exploits
وكبار	The
الترتيبات	Arrangements
تجده	Find
الأطراف	Parties
متفرج	Spectators
يوجه	Draws
قياسي	Record
السيف	Sword
يراد	To
ولئن	While
يقابل	Corresponds
صقر	Falcon
خسرت	Lost
دعاة	Advocates
الامان	Safety
معدات	Equipment
أحق	Deserving
الفضيل	Fadil
يشرف	Oversees
خامات	Ores
عبرة	Lesson
ذاتية	Self
ردود	Replies
العصبية	Nerve
جليا	Clear
المتنقلة	Mobile
لأمر	To
والتجارب	And
كائن	Object
البرواني	Barwani
يتوفر	Available
اجر	Pay
مسئولون	Officials
بمتابعة	Followup
نفذ	Carried
جريدة	Newspaper
تبعا	Depending
والعلاج	And
بمعهد	Institute
بمشيئة	Willing
الغساني	Ghassani
بالمرسوم	Decree
البارز	Prominent
الديموقراطية	Democracy
الزراعى	Agricultural
يدعى	Called
دراستها	Studied
البعثات	Missions
الظلمات	Darkness
والشركة	The
وأعضاء	And
تعاملات	Government
النباتات	Plants
اليونسكو	UNESCO
لتقييم	To
يشتبه	Suspected
المدينة	City
ذرة	Atom
الراسبي	Rasbi
اكمل	Completed
بالصلاة	Prayer
توسع	Expansion
الكفار	Infidels
وكثيرا	And
وأحيانا	And
ويدخل	And
مواطنه	Compatriot
ضخ	Pumping
فنسأل	We
مستوياتها	Levels
الجنسين	Gender
فإني	I
ودولة	And
المخططات	Charts
متميزا	Distinct
والخوف	And
الدوافع	Motives
ضيوف	Guests
طبق	Dish
وعاد	And
وخليفة	Khalifa
بالصبر	Patient
والجمال	And
المتجددة	Renewable
انتقلت	Moved
وخمسين	And
واجهزة	The
المتحدة	United
يخلو	Devoid
والجامعات	And
المشاهدين	Viewers
سمح	Allowed
مزيدا	Further
وأوصى	The
وفرض	And
اليحيائي	Yahyai
أحوال	Conditions
قدراته	Its
والشاعر	And
تنزل	Descend
حقوقهم	Their
بالصورة	Picture
مضمار	Track
زرع	Planting
والنشر	And
المزمع	Planned
الطوارئ	Emergency
لمركز	Center
يليق	Befitting
تتصل	Relate
تنتظر	Waiting
وولاية	And
للتراث	Heritage
دافعا	Motivation
بثلاث	Three
ويقع	And
يمكنهم	Can
المضمار	Track
الاحساس	Sense
الملائم	Appropriate
العينات	Samples
انهيار	Collapse
الثمار	Fruits
والتحديات	And
وينقل	And
خلفية	Background
انى	I
أدلة	Evidence
المحاسبة	Accounting
ناجح	Successful
يومئذ	That
طلوع	Rises
نفى	Denied
ليلى	Leila
التكوين	Configuration
والتسهيلات	And
يملكون	Have
تصلح	Serve
وعمر	And
تدعم	Supports
اليعقوبي	Yacoubi
التعديلات	Amendments
مشارك	Associate
كلها	All
شوارع	Streets
حدثني	Told
مجموعته	His
القدوة	Kidwa
يمنح	Granted
تحد	Limit
بضع	Few
القائمون	Organizers
ألقت	Threw
واقعا	The
بقرار	Resolution
موقعها	Its
وخسر	And
زمام	Reins
الكشفية	Scout
أعطي	Give
الادوية	Medicine
لشركات	Companies
هادفة	Purposeful
الحصص	Quotas
وتكريم	And
مرشح	Candidate
شرا	Evil
الشبلي	Shibli
اتباعه	Followed
قبلكم	Before
فالإنسان	Man
الاندونيسية	Indonesian
وافقت	Approved
تلقت	Received
للبنات	Girls
الجوار	Neighbourhood
بلادهم	Home
مهدي	Mehdi
الصمت	Silence
اقوى	Stronger
المخلوق	Creature
ومواد	And
المسار	Track
الشريط	Tape
خيار	Option
وظهر	And
والاعمال	Business
الرشيد	Rasheed
الليالي	Nights
بايرن	Bayern
والجزائر	Algeria
الحوافز	Incentives
كيرى	Kerry
المسكري	Maskery
أئمة	Imams
ضده	Against
الحلبة	Ring
توجهات	Orientations
التخلف	Underdevelopment
حدثنا	Tell
الشقيقين	Brotherly
وتركيب	And
والعرب	And
سيتي	City
بتلاوة	Recitation
الأكل	Eating
طفلا	Children
وسوء	And
يسري	Applies
الغالب	Often
للمستثمرين	Investors
جنة	Committee
شعبة	Division
العلم	Science
تقريرا	Report
المبين	Set
أكن	I
عمه	Uncle
شوطا	Way
الكهف	Cave
لاسباب	For
بالحياة	Life
الارشادية	Extension
للحرب	For
الشافعي	Shafei
رزق	Rizk
يؤخذ	Taken
الالوان	Colors
موقفا	Position
وبقي	And
اجمل	Beautiful
الهلالي	Hilali
اسلام	Islam
والمبادئ	And
تشويه	Distortion
تحث	Urges
لحفظ	To
الصفة	Capacity
اموال	Money
مساحات	Spaces
تتعامل	Dealing
المجلات	Magazines
التأمل	Meditation
يدري	Knows
الطهارة	Purity
عقوبات	Penalties
الكافرين	Unbelievers
المدنيين	Civilians
بورصة	Stock
ومسابقة	Competition
المحدود	Limited
مصفاة	Refinery
مؤلفات	Books
اغلاق	Closing
والعياذ	And
والإبداع	And
يتذكر	Remember
نظره	View
وانشطة	And
ببراعة	Masterfully
ولادة	The
سمة	Feature
النيل	Nile
ووصل	And
الناصية	Forelock
موجودا	Located
كسر	Break
المثيرة	Exciting
مسح	Survey
لرجل	Of
هداف	Scorer
يحس	Felt
والابداع	And
الشراء	Buying
مجمل	Total
حياتك	Life
النظريات	Theories
وبدون	Without
مخصصة	Custom
اوضحت	Said
لاصحاب	For
ضغوط	Pressure
تصدى	Saved
ومهارات	Skills
وهدى	Huda
الاطباء	Doctors
الخلية	Cell
حبه	Love
شيئا	Something
ينعكس	Reflected
الابتعاد	Away
قلبك	Heart
لتشجيع	To
راية	Banner
وطريقة	The
استاذ	Professor
والشعوب	And
بسيط	Simple
تؤمن	Believes
تراجعت	Fell
وبطولة	Championship
الحسابات	Accounts
طبقة	Layer
داء	Diabetes
منظور	Perspective
والمخرج	And
علقة	Leech
تخريج	Graduation
مديرية	Directorate
المساء	Evening
والمنطقة	The
للتعبير	To
المشتبه	Suspect
اشد	Most
والمسلمون	Muslims
لتسهيل	To
تفكير	Thinking
للجامعة	University
زوج	Pair
تليها	Followed
التكنولوجية	Technological
ويزيد	And
أنابيب	Pipe
النهر	River
وجعلان	And
المعاناة	Suffering
للواقع	Of
استثناء	Exception
الحجرات	Closets
تكتمل	Completed
الأندلس	Andalusia
ظن	Thought
ويحاول	And
وقواعد	And
وصحار	Sohar
فخلقنا	Fajlguena
للسينما	Film
دراسية	Study
نجيب	Najib
لهو	Fun
والنصارى	And
الودائع	Deposits
والقمر	Moon
ه	E
بركلات	Penalty
ويعرف	And
فقه	Jurisprudence
قنوات	Channels
جنيف	Geneva
لوس	Los
تنتقل	Transmitted
والسياحية	And
النهج	Approach
وقطع	And
لمساعدة	To
الرواة	Narrators
تعظيم	Maximize
بالدوحة	Doha
تجميع	Assembling
وضوح	Clarity
الاقتراع	Polling
البترول	Oil
عليا	Top
وحث	Urged
الترفيهية	Leisure
ق	BC
والبالغ	And
اقدم	Oldest
الاسود	Black
والاجهزة	And
الأهم	More
صيد	Fishing
ممثلين	Representatives
تعلق	Attached
لمصلحة	For
فاروق	Farouk
للسوق	Market
الأعداء	Enemies
أكان	Whether
الجغرافية	Geographic
لترويج	To
للنظر	To
ابواب	Doors
وكتب	And
ولده	Generated
الاستغناء	Dispensed
المصرى	Egyptian
بحسن	Good
المشاة	Infantry
أسلم	Aslam
بأنفسهم	Themselves
اولاد	Sons
الميراث	Inheritance
المنطقة	Region
المؤقت	Interim
زيدان	Zidane
هونغ	Hong
نية	Intention
المنطق	Logic
اتساع	Breadth
لدورة	To
الأسس	Foundations
أوائل	Early
اطفال	Kids
أسر	Families
السلطنة	Oman
نظافة	Cleaner
أمرنا	Commanded
الشبهات	Suspicions
تعليق	Comment
دوليا	Internationally
جعلنا	Made
طرحت	Raised
والمتمثلة	And
السائد	Prevailing
التدخين	Smoking
الشيعة	Shiites
الابناء	Filial
بشرية	Human
سعادتها	Happiness
وانخفض	And
الأمثل	Optimal
لينتهي	Ends
تمثيل	Represent
السويدي	Swedish
الوزن	Weight
النزاع	Conflict
القدامى	Old
تطبق	Apply
ونجد	We
الناجح	Successful
ميادين	Fields
ساعدت	Helped
ونرى	And
انتزاع	Extract
أصحابها	Owners
بصعوبة	Barely
نادرة	Rare
ويبدأ	And
لبلدية	Municipal
والمعدات	And
اللتين	Two
وخرجت	And
فطرة	Encroachment
تحفظ	Reservation
ككل	Whole
وسائر	The
نراه	See
ويعتقد	And
بعمليات	Operations
الحلوى	Candy
والدور	And
ليتم	To
المسجلة	Registered
صانع	Maker
يتمنى	Wish
يدخلون	Entering
أكمل	Completed
القناة	Channel
الغني	Rich
العالمية	World
للارتقاء	To
بالعلم	Science
أظهر	Showed
الاضحى	Adha
متعة	Fun
الذكاء	IQ
معظمها	Mostly
العليم	Knowing
أجواء	Atmosphere
لصالحه	For
بالدول	States
والدي	The
البحثية	Research
تقديمه	Submitted
القياس	Measurement
اتهامات	Charges
بأول	First
افتتحت	Opened
والجهود	And
تشلسي	Chelsea
أوسع	Wider
بتقدم	Progress
دولار	US
التصدي	Address
مباحثات	Talks
فكما	As
الجنسيات	Nationalities
وحي	Inspired
الغيب	Unseen
المائي	Water
منير	Munir
والفرق	The
قولا	Word
بالجيش	Army
ماديا	Materially
النبات	Plant
والسلطنة	The
اللغوي	Linguistic
ومكافحة	The
فتكون	Vtkon
ورب	Lord
التحولات	Transformations
سفينة	Ship
مفتوحا	Open
أبيه	His
الانابيب	Pipe
والتكامل	And
المعطيات	Data
للدراسة	To
المترتبة	Implications
ومعالجة	And
المنتخبان	Teams
ويجري	Being
بالبحث	Searching
الجلسات	Sessions
نوعه	Kind
عينيه	Eyes
طراز	Model
فرصا	Opportunities
إليها	To
رئيسيا	Key
فأما	Either
الإبداعية	Creative
كلارك	Clark
والتسويق	Marketing
تختص	Specializes
المكون	Component
وكرة	The
العصرية	Trendy
كثيرا	Lot
والمساكين	And
وكنا	And
المقترحات	Proposals
رده	Responding
أعرف	Know
وتسهيل	And
الهدوء	Calm
الحواس	Senses
والترويج	And
كله	All
الشرط	Condition
التعاملات	Transactions
المقترح	Proposed
وبات	And
يوحي	Suggests
السنن	Sunan
وتقنية	And
مصنع	Factory
وحياة	The
الدماء	Blood
نشأ	Grew
أقدم	Older
والعلم	
التتويج	Coronation
الينا	Us
محاربة	Fight
يخالف	Violates
القت	Dropped
مجتمعاتنا	Our
جاهزة	Ready
مقاطعة	District
الإداري	Administrative
المسيح	Christ
ملعبه	Home
وذاك	And
مشوار	Career
بالمرأة	Women
مثالا	Example
سان	San
للمشاركين	Participants
الديوان	SAI
متفرقة	Sporadic
وقدرته	And
الحاسمة	Critical
مصدرا	Source
يضاف	Added
السور	Fence
شاكر	Shaker
تجب	Should
بالجهود	Efforts
تلتقي	Converge
نهائيا	Final
للجهود	The
معتبرا	Adding
لكسب	To
يغفر	Forgive
الامني	Security
المشايخ	Sheikhs
ابدى	Showed
المتطلبات	Requirements
يتسنى	Enable
الهداية	Hedaya
خلايا	Cells
وسرعة	The
البنى	Structures
لاتحاد	Union
بالسيب	Seeb
القتبي	Qatabi
وخارج	And
رواد	Pioneers
يضيع	Lost
مؤلف	Author
دوار	Circle
وقطاع	The
مرتبة	Rank
الوثب	Jump
لليوم	Day
وتمنى	And
الدواء	Medicine
انفلونزا	Flu
اكتشف	Discovered
المفتش	Inspector
شعره	Hair
يفوز	Wins
ومجلس	And
وصيته	His
استطلاع	Poll
الجاد	Hard
تدفق	Flow
الموحد	Consolidated
موته	His
الناجمة	Caused
مرر	Passed
فجأة	Suddenly
أخبار	News
يصلون	Reach
9	
وينبغي	Should
ويمثل	Represents
أبعد	Beyond
لقائه	Meeting
خسائر	Losses
العد	Count
والاعتماد	And
احدهما	One
وفلسطين	The
المؤلفات	Literature
دارت	Dart
التدريسية	Teaching
الأقوال	Sayings
العظمى	Great
المرهون	Mortgaged
الاسابيع	Weeks
الصهيوني	Zionist
يقرر	Decides
والصلاة	Prayer
وحق	Right
العضو	User
الاعجاز	Miracles
فردي	Individually
الاخرى	Other
ضنك	Miserable
كاد	Almost
الكلي	Total
النسيج	Fabric
جمعيات	Associations
لبدء	To
تعزز	Promotes
اشعر	I
يطمح	Aspire
يومه	Day
والمانيا	Germany
المتطوعات	Volunteers
والمناهج	And
السكاني	Population
الثقيلة	Heavy
القائل	View
نتائجها	Results
لبيع	To
قيس	Qais
وبه	And
السوء	Bad
يكمن	Lies
الأثرية	Archaeological
والعاملين	And
للتأكد	To
والتفكير	And
يرفض	Rejects
وكافة	And
الخيرات	Khairat
يجتمع	Meet
وتتمثل	The
والإسلامية	The
قوما	Folk
مسيرته	His
الغيلاني	Ghilani
المحافل	Forums
والخروج	And
تشكيلة	Range
هوليوود	Hollywood
الرضاعة	Breastfeeding
بأننا	We
اهتمامه	Interest
الإنترنت	Internet
والأنشطة	And
وأوضحت	Explained
السبعة	Seven
اليهودي	Jewish
كثر	Lot
لمواصلة	To
الفترات	Periods
الارتباط	Link
بالخير	Well
والحكم	Governance
المثقف	Bookworm
سياسيا	Politically
بالدم	Blood
أوجه	Draw
اساسيا	Key
بمشروع	Project
المستقلة	Independent
كمثل	Like
تمنح	Granted
للصلاة	To
تغييرا	Change
توزع	Distributed
العملاقة	Giant
يدع	Beyond
ينسى	Forget
رياض	Riad
التوكل	Trust
الكم	Quantum
بيضاء	White
الرقي	Sophistication
للمنتجات	Products
يشترط	Requires
الجرائم	Crimes
والمفكرين	And
بكرة	Reel
منظمات	Organizations
إلقاء	Shed
فكري	Fikri
سلبيا	Negative
اللاتينية	Latin
والملاحة	And
صيام	Siam
لأنني	I
خارجها	Outside
لحياة	For
الأحياء	Biology
وساعده	And
التشريعي	Legislative
ستبدأ	Begin
الاجابة	Answer
الرضا	Satisfaction
دمج	Merge
تأخير	Delay
الشاعرة	Poet
الرائد	Leading
وأتمنى	I
الحاجز	Barrier
ذبح	Slaughter
المسرحيات	Plays
الناقة	Camel
المركزين	Centers
قرون	Centuries
داخلي	Internal
العلي	Ali
اعقاب	After
الكافر	Infidel
لذوي	With
بطرق	Ways
التحليل	Analysis
الظالمين	Oppressors
ملكية	Ownership
وزيارة	And
تفضل	Prefer
ياأيها	O
لكان	To
رقية	Paper
الجزائرية	Algerian
والتربوية	And
عقول	Minds
وتسجيل	And
سيارته	Car
والغرب	And
تأثيرا	Influential
اجازة	Vacation
الكفيلة	Ensure
الصلوات	Prayers
شابا	Young
فحص	Examined
الغاء	Cancel
يتعلم	Learns
يكره	Hates
المباحثات	Talks
والخطط	And
تفتيش	Searches
شاركوا	Involved
الإحساس	Sense
حرمة	Sanctity
حيدر	Haider
مجالا	Room
بكأس	Cup
منصبه	Office
الأجانب	Foreigners
ملاعب	Courts
الخوض	Delving
أنظمة	Systems
الخطرة	Dangerous
الفعالية	Hits
ويكفي	Suffice
التسعينيات	Nineties
سمو	HH
سيشارك	Will
الصواب	Right
احتلال	Occupy
المبدأ	Principle
وشرطة	Police
رأت	Saw
وكلها	All
يومية	Day
لابن	I'm
الأحمر	Red
وضمان	And
تدريباته	His
مناسك	Rituals
وظفار	Dhofar
سمعه	Heard
يشار	Referred
التمريض	Nursing
المستشرقين	Orientalists
وقتها	And
والإنسان	The
تفقد	Lose
الوصف	Description
النجاة	Deliverance
فكم	How
والتاريخية	The
العامين	Two
أردت	You
الافغانية	Afghan
تنفذها	Carried
بتطبيق	Applying
الفم	Mouth
مناخ	Climate
تنتشر	Spread
البروفيسور	Professor
الواقع	Actually
يفرق	Differentiates
فقدت	Lost
التواجد	Presence
وبكل	And
معرضا	Exhibit
بالطريقة	Way
الحس	Sense
وكثرة	And
يستضيف	Hosts
الجهوري	Loud
تقديمها	Submitted
اثارة	Stirring
الدفعة	Installment
المطلقة	Absolute
الأسلحة	Weapons
الإجابة	Answer
العقبة	Aqaba
رايس	Rice
الطلابي	Student
الاستراتيجي	Strategic
الكثيرون	Many
النعيمي	Naimi
رأسهم	Led
المكسيك	Mexico
تهديد	Threaten
فأنت	You
ومنع	And
مبيعات	Sales
برونزية	Bronze
تكثيف	Intensification
نداء	Call
نهج	Approach
شريطة	Provided
تركيز	Concentration
ينفذ	Performs
خلافا	Unlike
جادة	Avenue
الفتن	Tribulations
مفردات	Vocabulary
الباقي	Remaining
الاسترالية	Australian
حدا	End
الآبار	Wells
يميل	Tends
المشار	Referred
والرياضية	The
ودوره	The
ملموس	Concrete
طاقم	Site
ركزت	Focused
نسمع	Hear
تكتب	Write
تسيطر	Controlled
ولأن	Because
الدرامي	Dramatic
ويظهر	Shows
اقول	Tell
الفيفا	FIFA
عروضا	Offers
غرس	Planting
الفيديو	Video
اشياء	Things
محاكمة	Trial
لفعاليات	Events
جار	Neighbor
امانة	Municipality
الاتهامات	Charges
العمانيون	Omanis
المطلق	Absolute
وعلماء	The
وطريق	By
وعماد	Imad
رقما	Number
ولكنني	But
التصميم	Design
ازمة	Crisis
وسلامة	And
مخاوف	Fears
الوكيل	Agent
جاكرتا	Jakarta
النموذج	Form
أمثلة	Examples
الدورى	League
وخدمات	And
الأربعاء	Wednesday
وثقافية	And
اختراق	Penetrate
مسبقا	Pre
التقديرية	Estimated
قرعة	Draw
بشتى	Various
متوسطة	Medium
للدعوة	To
بعينه	Given
تحب	Like
الرياضيات	Math
الألوان	Colors
الزعيم	Leader
تأخر	Delayed
طال	Long
لإقامة	To
واعتماد	And
المنورة	Medina
الأمة	Nation
يتحول	Turns
ليسجل	To
تمتاز	Features
تحتفل	Celebrates
وبسبب	Because
خمسين	Fiftieth
العشاء	Dinner
بالماء	Water
انظمة	Systems
زواج	Marriage
الخيرية	Charity
توافر	Availability
بنقل	Transfer
واننا	We
المتقدم	Advanced
العملاء	Customer
الكتاب	Book
الذهني	Mental
وكأنها	Like
الضرر	Damage
الأوقات	Times
أخرجت	Drove
محبوب	Lovable
حصة	Share
البلاط	Tiles
مرافق	Facilities
الذكور	Male
الانضمام	Join
للجمعية	Assembly
رئيسي	Key
فيينا	Vienna
أصيب	Wounded
وردا	Responding
الوصية	Commandment
يدرس	Studying
الغنائية	Lyrical
الشمالي	North
قيود	Restrictions
المتواصلة	Continuous
وبعضها	And
الدفاعية	Defensive
أفلا	Do
البهجة	Delight
الشرقي	East
تحصيل	Collection
وإنا	And
تصنيف	Rated
البينية	Intra
فينا	Vina
وجنوب	The
مدربا	Coach
بوجه	Generally
مكي	Mackie
المساكن	Housing
تمارس	Exercised
عموم	Pan
المحل	Shop
ميزة	Feature
فمنهم	Some
السموات	Heavens
ويختتم	And
لعقد	To
دامت	Lasted
فقرة	Paragraph
وصوله	The
الاشتراك	Up
الأدلة	Evidence
المساعد	Assistant
إنك	Inc
الجغرافي	Geographical
ممثلي	Representatives
موحدة	Standard
المحافظات	Governorates
والكثير	And
يوفنتوس	Juventus
حكام	Rulers
طين	Clay
هدفها	Its
توقيت	Timing
القرآن	Quran
الساعات	Clocks
القيود	Restrictions
الاونة	Recent
استعرض	Reviewed
الهمزة	Hamza
يتحرك	Moving
كثيرون	Many
كأنها	Like
بيني	Benny
نبذة	About
لسنا	Not
معناه	Meaning
مسلحين	Gunmen
الكافي	Adequate
والمنافسة	And
الوسيلة	Means
أسامة	Osama
تسأل	Ask
يصور	Depicts
التعاقد	Hiring
ويسر	Is
واسعا	Wide
التوبي	Tobi
استيراد	Import
والفوز	And
مصطلحات	Terminology
تمنع	Prevent
رمز	Code
وتمكن	And
يتواصل	Continues
لواء	Brigade
الصحابي	Companion
وعمان	And
عثر	Found
العسل	Honey
غفير	Legion
أمنية	Security
وشهد	Saw
العلة	Malady
الريان	Rayan
بدقة	Accurately
والحب	Love
الاصول	Assets
اعظم	Greatest
المدافعين	Defenders
الزرقاوي	Zarqawi
سجن	Prison
سبيلا	Avenue
أعداء	Enemies
طبعا	Course
للحج	Pilgrimage
النسب	Ratios
نقطتين	Two
المكلف	Designate
ابعاد	Dimensions
سائق	Driver
عايل	Ayel
لا	Not
المجالس	Councils
مناسبا	Appropriate
والمناشط	And
واعلن	And
الدموية	Vessels
يبني	Build
أتمنى	I
اوزبكستان	Uzbekistan
الاستجابة	Response
سليمة	Sound
وحركة	And
يمتد	Extends
اشكال	Forms
تفيد	Stating
وخمسة	And
معاذ	Maaz
تأتى	Comes
الانحراف	Deviation
خاضها	Fought
الخفيف	Light
بال	PAL
يكونون	Are
ينص	Provides
بمدارس	Schools
التحكم	Control
الاقصى	Far
صديق	Friend
يحمله	Holds
إدراك	Perception
التنافسية	Competitive
الشام	Sham
الصديق	Siddiq
والمعلمين	And
المحدودة	Ltd
وأكدت	And
الإعلان	Ad
شعرا	Poetry
يخفى	Secret
جلال	Jalal
المجد	Glory
فسبحان	Glory
التأليف	Authoring
درهم	AED
لرويترز	Reuters
الموصل	Mosul
والشكر	Thanksgiving
يبق	Left
الفرعية	Sub
والدينية	And
ليوم	Day
اشراف	Oversee
والدعم	And
انتاجية	Productivity
متطورة	Advanced
بمستشفى	Hospital
يأتى	Comes
تتوقف	Stop
شديدا	Severe
صحيحا	True
يطلع	Seen
قبله	Before
والمنظمات	And
حرارة	Heat
والتعديل	Amendment
وسبق	And
طاقات	Energies
يسقط	Down
حصن	Fort
الضيق	Narrow
شعوب	Peoples
ووصف	Description
ولولا	Without
غالبية	Majority
جنبا	Side
والرحمة	And
والصبر	And
حكاية	Tale
أخيرا	Finally
يحافظ	Maintains
الانسحاب	Withdrawal
يجدون	Find
العوابي	Awabi
إيجابية	Positive
رحلات	Cruises
انخفضت	Dropped
تسجل	Recorded
لأبي	Abi
والفنان	The
تعاليم	Teachings
امله	Hope
الرابطة	Association
الورق	Paper
نسأل	Ask
شرعا	Religiously
غنى	Sang
اسمها	Called
نفذها	Carried
الدوام	Always
الوقوع	Falling
عنها	About
مربع	Box
عسكري	Military
والقيام	And
السائق	Driver
إمام	Imam
واصبحت	And
التوتر	Tension
فعالياتها	Events
فيغو	Figo
الجزيل	Thanks
فضية	Silver
والسيب	Seeb
صقل	Refine
ومعنى	And
الجماهيري	Mass
كركوك	Kirkuk
شهود	Witnesses
مبكرة	Early
وامام	And
وبنك	The
حماس	Hamas
أواخر	Late
توليه	Assuming
ادنى	Minimum
الأولية	Initial
الأسود	Black
تجاري	Commercial
الممثلة	Actress
قطب	Pole
تعلن	Announces
وبعضهم	Some
لتصبح	To
الإماراتي	Emirati
وتذكر	And
المستثمر	Investor
لقي	Received
المتسابقين	Contestants
للمسلم	Muslim
الاقفال	Closing
لتنتهي	Ending
سلة	Basket
التمسك	Stick
إصلاح	Repair
قائل	Someone
غاب	Missed
ظلال	Shades
وألا	And
الاسلام	Islam
أولمبياد	Olympics
بالحكمة	Wisdom
للانتخابات	Elections
نقدم	Offer
الجابرية	Jabriya
بتوقيت	Are
المتكاملة	Integrated
يصنع	Makes
سماع	Hear
وتوسيع	And
الاستهلاكية	Consumer
العراقى	Iraqi
عصرا	Pm
الألفاظ	Words
المسيحية	Christianity
المشوار	Career
لدن	Thermoplastic
بالعيد	Day
بيتر	Peter
محاسبة	Accounting
المتألق	Brilliant
المبدعين	Creators
الخلافات	Differences
وتحمل	And
والباحثين	The
اللفظ	Pronunciation
جاهدة	Hard
هدفي	My
الضعيف	Weak
للجيش	Army
الضرورة	Necessary
والقواعد	And
الخرطوم	Khartoum
كيان	Entity
سالمين	Salmin
استنادا	Based
استراتيجيات	Strategies
للعلاج	For
ظاهر	Zahir
ماهر	Maher
عاما	Years
خطرا	Dangerous
تحدثنا	Talked
ندرك	Realize
مصيبة	Misfortune
الجزائية	Criminal
استمارة	Form
عنا	US
وجمهورية	The
صناديق	Funds
للشعب	People
سعيا	Order
تصب	Pour
الهزيمة	Defeat
اضطر	Forced
الأمان	Safety
شريط	Bar
يحكم	Governs
والتعامل	And
متناول	Reach
العاطفة	Passion
نائبا	Vice
التفوق	Excellence
الوظيفي	Career
الدقة	Resolution
افلام	Movies
للبيئة	Environment
الافريقي	AU
لأسباب	For
تتسم	Characterized
الجاسم	Jassim
العوائق	Barriers
فشلت	Failed
معمر	Muammar
احتفال	Celebrate
والحصول	And
أصحابنا	Our
وأمر	And
الحديث	Modern
تحل	Replace
استخدمت	Used
شكلا	Form
الإبل	Camel
ديني	Religious
غادر	Left
غروب	Group
يشعرون	Feel
الثانية	Second
الملائمة	Appropriate
ماسة	Urgent
وأساليب	And
صفحات	Pages
شناص	Shinas
وصاحب	His
الريفية	Rural
يقوله	Say
أعوام	Years
والارض	And
محبة	Love
كهرباء	Electricity
حبا	Love
الاخبار	News
أولاد	Boys
طموحات	Ambitions
النيابة	Prosecution
فؤاد	Fouad
صيغة	Formula
تغطي	Covering
استهلاك	Consumption
القابل	Stainless
والمحاضرات	And
وتتضمن	And
عتبة	Threshold
الجن	Gin
إعطاء	Give
نقلة	Shift
الأشهر	Months
تحقيقا	Investigation
البحرينية	Bahraini
وروي	And
للمعلمين	Teachers
العراقيون	Iraqis
خروجه	Exit
لانتاج	To
الكونية	Cosmic
استفادة	Benefit
تفكر	Think
البرية	Wild
فإنك	You
ندوات	Seminars
النعم	Graces
مواصفات	Specifications
قدراتهم	Their
الاخذ	Taking
اقتراح	Proposal
وصعد	Rose
والادارة	And
والعلماء	The
السويد	Sweden
والاجراءات	And
النقدي	Cash
تنص	Provides
المتصلة	Relating
الفعالة	Effective
والمسئولين	And
بلقب	Title
المعروضة	Displayed
والتقى	And
وحلقات	The
بالنفع	Benefit
وها	Here
تقيم	Evaluated
كليا	Totally
إبريل	April
بولايات	Holders
ومنح	And
بالمقارنة	Compared
الهوى	Hawa
تجهيز	Processing
رياضي	Athletic
واعرب	He
تدهور	Deterioration
جمعه	Collected
والآخر	And
مهارة	Skill
المختلفة	Different
لئن	While
يأمر	Ordering
الناتجة	Resulting
يعادل	Equivalent
تتحقق	Achieved
لممارسة	To
التسليم	Delivery
لجمع	To
تقوية	Strengthening
المميز	Featured
تمثلت	Was
يكفل	Ensure
وقفة	Pause
الأوراق	Securities
للسنة	For
أقسام	Sections
ويوضح	Explains
لنظام	System
يجعله	Makes
استفاد	Benefited
المقال	Article
ها	Ha
الإسلامي	Islamic
حكيم	Sage
الثمن	Price
اعمار	Emaar
للفرق	For
المعجم	Lexicon
يوافق	Approves
أليس	Alice
والتركيز	And
الانضباط	Discipline
قانونية	Legal
لأداء	To
الجدول	Table
اليهودية	Judaism
حسام	Hossam
فور	Four
اقصى	Maximum
أناس	People
اطلق	Fired
ارهابية	Terrorist
تشتهر	Famous
نفسا	Breath
الخطورة	Dangerous
الالتحاق	Enrollment
الكثيرين	Many
الكيميائية	Chemical
وحمد	Hamad
توزيعها	Distributed
وبالفعل	And
للراليات	Rally
المعلوم	Known
والنهي	And
العملة	Currency
الدواجن	Poultry
وأصبحت	And
السنية	Sunni
عجلة	Wheel
والاعلام	And
بفتح	Open
باجراء	Hold
لبحث	Search
للرسول	Messenger
الآخرون	Others
لانجاح	To
الجارى	Current
الأميركيين	American
اللبن	Milk
يتقدم	Advancing
قصير	Short
الادلة	Evidence
المساحة	Area
فقدان	Loss
تحديث	Reload
الماشية	Cattle
للفن	Art
والاسلام	And
يلقي	Sheds
الادب	Literature
المستوردة	Imported
المقاتلين	Fighters
الرمي	Throwing
النطفة	Sperm
الاجيال	Generations
لدخول	To
باطن	Soles
مفتاح	Key
تجسد	Embody
رخصة	License
وتونس	Tunisia
فارق	Difference
ريتشارد	Richard
كن	Be
ومحافظ	And
تصدير	Export
ويلعب	And
مرورا	Passing
المحتمل	Probably
وأول	The
والاهلية	Civil
المتبادلة	Mutual
زملائه	Colleagues
ردا	Response
للأسف	Unfortunately
الاسترالي	Australian
مكانها	Place
ودية	Friendly
العنوان	Address
الأدوار	Roles
فاعلة	Actor
الاختبار	Test
السنغال	Senegal
حاجز	Barrier
وجهت	Directed
معلوم	Unknown
بعدة	Several
طبيب	Doctor
يحضر	Attend
درع	Shield
اجتماعي	Social
يتأثر	Affected
منوها	Alluding
والإسلام	Islam
صناعية	Industrial
طائرات	Aircraft
تخضع	Subject
بخير	Okay
المضافة	Added
سبقت	Before
الدين	Religion
علاوي	Allawi
اهتم	Care
واحدة	One
علمنا	Taught
المعنيين	Involved
فالقرآن	Qur'an
بهوان	Bahwan
لقطاع	Sector
تبعد	About
ضرورية	Necessary
الذهن	Mind
الجناح	Suite
المقداد	Miqdad
الخ	Etc
لولاية	State
طلبت	Asked
ديننا	Our
شبابنا	Our
يتبع	Followed
للمسابقة	Competition
اتصالات	Communications
مثلها	Like
التضخم	Inflation
وحيث	And
عباد	Sunflower
رفعت	Raised
أمانة	Secretariat
ومجموعة	The
يقطع	Cut
تولي	Take
كمن	Like
الدرامية	Dramatic
طاهر	Taher
يكسب	Earns
رقابة	Control
الهواتف	Phone
خلية	Cell
الايطالية	Italian
حيال	About
كريمة	Decent
ومتى	When
ينظرون	See
الرازي	Razi
والاردن	Jordan
الشتاء	Winter
الناطق	Spokesman
يتحمل	Bear
اللجوء	Seekers
خالية	Free
الخيول	Horses
ومنظمة	The
ثان	Than
باذن	Willing
الفعلية	Actual
واتخاذ	And
بالكثير	Lot
وبحث	Search
أحاديث	Conversations
بالنظر	Given
شريف	Sharif
والقيم	And
بالحديث	Talking
والنجاح	Success
إيمانا	Believing
عبرت	Crossed
الكائن	The
الميزان	Balance
فائزا	Winner
اجواء	Airs
تسوية	Settlement
يستقبل	Receives
اليمين	Right
رجالا	Men
احدا	One
الزوجين	Couple
قفز	Jumped
جدار	Wall
لانشاء	Generation
الجادة	Avenue
والتأكد	And
الساحل	Coast
متحدث	Speaker
ضمت	Included
دعوته	Call
والتوجيه	Directive
ثروة	Fortune
استقطاب	Attract
تراث	Heritage
سامي	Sami
موقفه	Position
الآخر	The
اولياء	Parents
شاهين	Shaheen
أميركي	US
واصدار	And
تأجيل	Delay
طرحها	Asked
وظل	Remained
انسانية	Humanitarian
يشغل	Occupies
بجولة	Touring
وبريطانيا	And
المسافة	Distance
التخصص	Specialization
اقامته	His
المنشودة	Desired
ومهما	Whatever
اجزاء	Parts
المال	Money
للقضاء	To
قابلة	Are
حجه	Hajj
واجبة	Due
الحميد	Hamid
تطويرها	Developed
الأوائل	Top
الضرائب	Taxes
والرسول	The
موجة	Wave
بقطاع	Sector
الشبابية	Youth
وإما	And
مجتمعنا	Our
سمات	Attributes
يختص	Respect
نووية	Nuclear
وجودها	The
جاره	Neighbor
المسيرة	March
الفور	Immediately
والشعر	Hair
الأبناء	Sons
والرابع	The
مناشط	مناشط
أنثى	Female
لقوم	Folk
نتائجه	Results
بتسليم	Delivered
موحد	Unified
ايجابيا	Positive
المخلوقات	Creatures
تخلو	Devoid
ينكر	Deny
فاضل	Fadel
طاعة	Obedience
وأهمية	The
صارت	Become
ابتغاء	Order
النمسا	Austria
بلغة	Language
يحفظ	Saves
أثار	Raised
مطلقا	Never
خدماتها	Services
وخدمة	And
واللجنة	Committee
الانفتاح	Opening
والمدارس	The
عرب	Arabs
الكفاءة	Efficiency
انظر	See
علق	Commented
غرار	Like
التكافل	Takaful
اسبوعين	Weeks
المربع	Box
ينطبق	Applies
لالوطن	Home
يسع	Accommodate
ليالي	S
الكلب	Dog
تثير	Raises
الصعوبة	Difficulty
كوبا	Cuba
الحماس	Enthusiasm
الرياضيين	Athletes
عائلة	Family
وأين	And
لشراء	To
وعضوية	The
نتحدث	Talking
طبية	Medical
البادي	Badi
أعد	Prepared
تحيط	Takes
القصوى	Maximum
الثاني	Second
فيلما	Film
رفيع	High
ووجود	And
ومنه	And
الشكيلي	Shukaily
للمياه	Water
الشعراوي	Hubert
ضابط	Officer
للتعريف	Definition
العون	Aid
الحصر	Limited
مفيدة	Useful
والتربية	Education
للمساهمة	To
اللحوم	Meat
التنفيذى	Executive
قديم	Old
والمسابقات	And
ايجابي	Positive
اخذت	Took
مردود	Yield
بديل	Alternative
اوائل	Early
ببناء	Building
صعد	Rose
ميزان	Balance
ممكنة	Possible
واستمر	And
بمكة	Mecca
الآسيوي	Asian
الظاهر	Apparent
درس	Studied
لئلا	Lest
العباد	Abbad
الإفاضة	Ifaadah
لانهم	Because
يجعلها	Makes
الاشجار	Trees
فحسب	Only
دينا	We
الوزارات	Ministries
يتردد	Frequented
الشهور	Months
قدموا	Gave
فاعل	Actor
الاسبانية	Spanish
معك	You
وجدوا	And
ش	St
احب	Like
إعلان	Announcement
النفطي	Oil
المنشطات	Doping
الاسماء	Names
ضعيف	Poor
الراغبين	Wishing
سيرة	Biography
خريجي	Graduates
المسلسلات	Series
ثماني	Eight
السوداني	Sudanese
طوكيو	Tokyo
نتوقع	Expect
للفنان	The
مرتفعا	Up
الاعمار	Construction
لمنتخب	Team
استمع	Listen
شن	Shen
يلقى	Thrown
الوقود	Fuel
اختبار	Test
لون	Color
الأنعام	An'am
السبعينيات	Seventies
مكثفة	Intense
البطاقات	Cards
المتقدمين	Applicants
يفيد	Benefit
فتاوى	Fatwas
خلقت	Created
بوعلي	Bouali
باعلوي	Ba'alawy
نعيم	Naim
أبى	Abi
صف	Row
غض	Juicy
معربا	Expressing
إشارة	Signal
ميداليات	Medals
مرتبط	Linked
للدراسات	Studies
الاحزاب	Parties
والتواصل	And
يستطيعون	Can
جنب	Side
يرتفع	Rises
اللياقة	Fitness
السرطان	Cancer
جماهيره	Fans
جامع	Collector
اشارت	Indicated
وتشغيل	And
شهور	Months
الشنفري	Shanfari
توفيق	Tawfiq
وتؤكد	And
غسل	Washing
اشواط	Games
الدوليين	International
الختامية	Final
المتزايد	Growing
اليوم	Day
التشكيل	Configuration
للوقوف	To
المصابين	Infected
مضغة	Embryo
والعناية	And
فردا	People
الأحد	Sunday
قدرا	Some
المستدامة	Sustainable
اثنان	Two
المحلل	Analyst
وضعه	Placed
أشكال	Forms
كلامه	His
الغالي	Dear
ايمانا	Believing
التنس	Tennis
الكاتبة	Writer
إنني	I
والالتزام	And
سرا	Secretly
نقد	Criticism
الفتيات	Girls
والآن	Now
امتلاك	Owning
لعدة	For
معاناة	Suffering
المعمول	Applicable
الاحياء	Neighborhoods
واهمية	The
فلذلك	Therefore
الفشل	Failure
والعملية	The
التطرق	Address
لعرض	To
بعقد	Holding
لسباق	Race
الطاعة	Obedience
التأكد	Sure
وعلينا	We
واشاد	Praised
تذهب	Go
يلاحظ	Notes
كابول	Kabul
دفعة	Batch
أجزاء	Parts
الذرية	Atomic
عاقبة	Consequence
التحدي	Challenge
وبمشاركة	And
تكاد	Almost
المنتشرة	Deployed
المتلقي	Receiving
الادوار	Floors
مخاطبة	Address
غزوة	Battle
السباقات	Races
فقهاء	Jurists
أشبه	Like
الشك	Uncertainty
يفترض	Assumes
الشهوات	Lusts
والناس	And
فعالية	Effectiveness
الشديدة	Severe
تعامل	Treated
أشارت	Indicated
الشراكة	Partnership
ليل	Lille
سواه	Others
لحم	Bethlehem
المحامين	Lawyers
الشارقة	Sharjah
ذاكرة	Memory
الزبير	Zubair
تبنى	Built
القراءات	Readings
المعروض	Supply
امنية	Security
الصفقات	Transactions
كأنما	As
التوظيف	Employment
سعي	Pursuit
ينتمي	Belongs
للتعامل	To
مطرح	Muttrah
والوسائل	And
عمرها	Old
اف	F
بالمناطق	Areas
الفضيلة	Virtue
وتشارك	And
والخارجية	Foreign
مشرفة	Senior
العريق	Ancient
الطفل	Child
روحي	Spiritual
أساسا	Essentially
المشتركين	Subscribers
ألقاها	Delivered
أسهم	Shares
الضوئي	Optical
للمسرح	Theatre
مديرة	Director
الباكستاني	Pakistan
لمجموعة	Group
فلسطينية	Palestinian
ورعاية	And
ارسنال	Arsenal
يفقد	Loses
والارتقاء	And
البارزة	Outstanding
المجلة	Journal
والنظر	And
بالمراكز	Centers
عرضة	Susceptible
بالشركة	Company
وأنها	And
الإعداد	Setup
الخاطئة	Erroneous
الإنكليزية	English
مدافع	Defender
للمحافظة	To
والحفاظ	And
تام	Tam
ورفض	And
الحركات	Movements
غرف	Rooms
شريحة	Slice
الآونة	Recent
وأهم	And
المتبقية	The
البرونزية	Bronze
بلادنا	Our
المعاصي	Sin
يكذب	Lying
بآيات	Verses
الامثل	Optimization
وكوريا	Korea
العمرة	Umrah
المتطورة	Advanced
لاعداد	To
والتكنولوجيا	And
ملحوظ	Markedly
محدود	Limited
وذهب	And
الصيادين	Fishermen
نهر	River
عندك	Have
وتوجيه	And
الشرك	Shirk
لكنني	But
آمنا	Safe
ارتباط	Link
رونالدو	Ronaldo
المسح	Survey
الفعال	Effective
مهمته	His
رسمي	Official
الأمثلة	Examples
المتوقعة	Projected
الشاشة	Screen
والرياضة	And
الظلام	Dark
فالنسيا	Valencia
ومراكز	The
جانبها	Part
الإطار	Box
والطرق	The
الواقعية	Realism
المتمثلة	Of
ياسين	Yassin
أذن	Authorized
تكشف	Reveals
مليونا	Million
تصرف	Disposal
للقوات	Force
للمركز	Center
مدخل	Entrance
وتبلغ	The
تزويد	Provide
المخيني	Mukhaini
إلغاء	Cancel
حسم	Resolution
الارقام	Numbers
ميزانية	Budget
للمخرج	Director
لمولانا	Maulana
مواهب	Talents
الشبكات	Networks
ذكرا	Male
الموعد	Date
لنشر	To
البلدي	Municipal
الدورية	Rotating
للاعبين	For
تتولى	Holds
اقتصاديا	Economically
للهيئة	For
حلت	Replaced
يتوجه	Heading
فريدة	Unique
سنن	Sunan
يغير	Change
التسبيح	Tasbeeh
الابداعية	Creative
الشحي	Shehhi
النسائي	Women's
حددت	Identified
لصاحبه	The
مكعب	Cubic
الخبر	News
بالحج	Hajj
لكتاب	Book
ثمريت	Thumrait
بقاء	Survival
امكانيات	Possibilities
الحداثة	Modernity
تقليص	Reduce
واكدت	And
ومتطلبات	And
ننسى	Forget
حظر	Ban
مجان	Majan
اسطبلات	Stables
قسمين	Two
اساسي	Key
والثالثة	The
كارلوس	Carlos
نظري	My
يقصد	Intended
نادى	Club
أعرب	Expressed
الميتة	Dead
المطر	Rain
والمهارات	And
تجربته	His
استثمارات	Investments
استيعاب	Accommodate
الاصيلة	Thoroughbreds
كانا	Were
اقليم	Province
بالغ	Deep
مروان	Marwan
ثورة	Revolution
سامية	Samia
ملحوظا	Remarkable
الجنوبي	Southern
رفضت	Rejected
الحبيب	Beloved
بغرض	To
استجابة	Response
تقليل	Reduce
الواضحة	Clear
المنزلية	Home
ثالثة	Third
باقامة	Establishment
كونغ	Kong
الصباحية	Morning
البنتاغون	Pentagon
القادسية	Qadisiyah
بشأنها	Thereon
اعمالها	Its
السعيد	Happy
فقالوا	They
لنادي	Club
والنهار	And
الاكاديمي	Academic
تفاعل	Interaction
فعالة	Effective
المباراتين	Games
الجبلية	Mountain
اسابيع	Weeks
انهاء	End
بالخوير	Khuwair
الجرح	Wound
لفظ	Word
والاجتهاد	And
يجلس	Sitting
ألوان	Colors
الضغوط	Pressure
مكونات	Components
شخصيا	Personally
منافسه	Rival
الأردني	Jordan
احياء	Revive
ويبين	Shows
ترسيخ	Consolidate
تزداد	Increased
يصعد	Climbs
الرائدة	Leading
تحرك	Move
ينظمها	Organized
بالبطولة	Championship
سريع	Fast
تسع	Nine
كاتب	Starter
الاختبارات	Tests
المضغة	Embryo
بينكم	You
السماوية	Heavenly
وافق	Approved
المصير	Determination
المركبة	Composite
بالكلية	Altogether
حسبما	As
المقترحة	Proposed
وأخذ	And
صوته	His
دولي	International
المعدات	Equipment
عاشور	Ashour
الحرفيين	Artisan
والمشايخ	The
تطورا	Sophisticated
القانوني	Legal
عادت	Returned
التفاهم	Understanding
حذر	Warned
تدشين	Launch
رابطة	Association
لعمل	To
للتنس	Tennis
الست	Six
لبرنامج	Program
والشئون	Affairs
وقتل	And
الضمير	Conscience
اقسام	Sections
وعلا	Ola
لهن	Them
وتسعى	Seeks
للأطفال	For
التربة	Soil
الروم	Roman
اتخذ	Taken
بدراسة	Studied
وقل	Say
جرائم	Crimes
تدريس	Teaching
سلطات	Authorities
التصدير	Export
زهرة	Flower
وأشارت	The
للمؤتمر	Conference
حاملة	Carrier
تجنب	Avoid
المعرفي	Cognitive
المستقيم	Rectal
المكتبات	Libraries
طعم	Taste
نملك	Have
الاخوة	Brothers
الربا	Usury
شعور	Feeling
بمجلس	Council
العميق	Deep
بحوث	Research
العادي	Normal
قدوة	Model
تتجه	Heading
التقدير	Appreciation
جدا	Very
بمصر	Egypt
السحاب	Sahab
فعال	Effectively
والدفاع	Defense
الحلال	I'm
أوقات	Times
الدعاة	Preachers
واكثر	And
التصرف	Disposition
الدرجات	Scores
يعانون	With
ومشاركة	And
يخضع	Subject
اسئلة	Questions
وجهها	Her
جوهر	Essence
حاله	Case
الطرح	Minus
يرضى	Pleases
تطورات	Developments
ليصبح	To
أنشطة	Activities
خوض	Contesting
سعة	Capacity
تنسيق	Coordination
للمواطن	Citizen
للنهوض	For
الإحرام	Ihram
رام	Ram
شهاب	Shihab
ألعاب	Games
وتقدير	The
الاعتراف	Recognition
المحاصيل	Crops
تناقش	Discusses
يطالب	Calling
الأيدي	Hands
فوزي	Fawzi
الولادة	Birth
المواصفات	Specifications
كتبه	Written
تربط	Connecting
دعت	Called
البلدة	Town
يمكنها	Can
اللاتي	Who
الأطباء	Physicians
امتحان	Exam
الاميركيون	US
الجامع	Whole
غريبا	Strange
الأخوة	Brothers
امراض	Disease
تسلم	Received
العمارة	Architecture
فتحت	Opened
نلاحظ	Note
رحم	Womb
سيئة	Bad
وقالوا	They
تميزت	Characterized
برغم	Despite
تطبيقها	Applied
بدعم	Support
اليورو	Euro
تخص	Belonging
المنظور	Perspective
توصلت	Reached
وكلية	College
الخمسية	FiveYear
الحادية	First
اعتمدت	Adopted
الرالي	Rally
شريك	Partner
العديدة	Numerous
لتبادل	To
الانتظار	Wait
يبعث	Sends
عميقة	Deep
الهالك	Deceased
الملاعب	Stadiums
كأنه	Like
متواصلة	Continuous
وقلة	And
اللحم	Meat
وعقد	And
العنصر	Element
وقراءة	And
فقيل	Was
توج	Crowned
الطاقات	Energies
باهتمام	Interest
والوصول	And
جماهير	Masses
ولعب	He
ينال	Receive
للزراعة	Agriculture
خبر	News
الانتباه	Attention
المرتفعة	High
أفكار	Ideas
يهتم	Cares
اصلاح	Repair
ينشأ	Originates
الكافية	Adequate
وتناول	And
أنتم	You
الأدبي	Literary
المستهلكين	Consumers
الغد	Tomorrow
لخوض	To
يعيشون	Live
اخرين	Others
استعادة	Restore
والقوة	And
اختتام	Closure
الهائل	Massive
يخسر	Loses
نورا	Nora
أسرار	Secrets
والرعاية	And
الاول	First
يعزز	Promotes
قيمته	Worth
الخسائر	Losses
الوقاية	Prevention
الملف	View
نسمة	People
أعمالهم	Their
يثير	Raises
الري	Irrigation
لمنع	To
ترتبط	Linked
مسرحي	Dramatist
العبادات	Worship
عمن	Who
دبأ	Dibba
غريبة	Strange
موسيقية	Instruments
واستغلال	And
طور	Developed
لحظات	Moments
لبيك	Beck
خليجية	Gulf
وضباط	Officers
عقوبة	Death
الأهمية	Important
بالكامل	Fully
يتفق	Line
المنذري	Mundhiri
يتصور	Imagine
الاباضي	Toes
تذكارية	Memorial
للمرحلة	Stage
الراهنة	Current
المتهم	Defendant
وكأنه	Like
الافتتاحية	Opening
يخشى	Fear
للنادي	Club
طيران	Air
وكشف	And
الفنادق	Hotels
رجع	Returned
الثواب	Reward
لرعاية	To
وجمال	Jamal
الخدمية	SOA
للمنافسة	Competition
محرم	Muharram
النسخة	Version
قومه	His
معطيات	Data
آخر	Last
منزله	His
فلماذا	Why
رأيه	His
شد	Lift
التفاصيل	Details
جهودها	Its
علمت	Learned
جواد	Jawad
السهل	Easy
بتحقيق	Achieving
تطرح	Put
للشؤون	Affairs
افب	AFP
الدروس	Lessons
السيرة	Biography
وتطويرها	And
الايسر	Left
المخاوف	Fears
وصالح	Saleh
يحملون	Carrying
الشهيرة	Famous
حقول	Fields
سعيدة	Happy
نزلت	I
المنامة	Manama
علاء	Alaa
سرعان	Quickly
زكي	Zaki
لتدريب	To
ركز	Focused
الجوي	Air
والمساهمة	And
صحفية	Press
الرزق	Livelihoods
ذكرى	Memory
أنباء	News
وطبيعة	Nature
الاخطاء	Mistakes
يعيد	Restores
ولجنة	Committee
الجهاد	Jihad
يقرب	Nearly
والثقافي	And
إنسانية	Humanitarian
الودية	Friendly
تنس	Tennis
الوداع	Farewell
المسئول	Charge
اوجه	Aspects
دعاء	Doaa
يعلن	Declares
وشدد	And
والهدف	The
قرن	Century
قرأت	Read
بنى	Built
ربوع	Across
ببطولة	Championship
مشاهدة	View
قلوبنا	Our
المحلى	Local
الاصوات	
مثيرة	Exciting
اسامة	Osama
تابعة	A
المهاجرين	Immigrants
التدخل	Intervention
يلقيها	Delivered
الناشئة	Emerging
تنقل	Transported
لكنهم	But
بالكويت	Kuwait
خطف	Kidnapped
الدمج	Merger
صاحبة	Her
آخرون	Others
القرعة	Pumpkin
اللحظات	Moments
خشبة	Stage
للقاء	To
الحكيمة	Wise
يحرز	Scoring
والاقتصادي	Economic
خصصت	Allocated
بنين	Boys
لصناعة	For
بحياة	Killed
الجار	Neighbor
الصالة	Hall
والمتابعة	And
حينها	Then
غوانتانامو	Guantanamo
عضوية	Membership
عقيدة	Doctrine
الأولاد	Boys
اتقوا	Fear
للعديد	For
الأخرى	Other
الموانئ	Ports
حامد	Hamid
يزداد	Increased
لتفعيل	To
للعلوم	Science
خشية	Lest
م	AD
إسلامي	Islamic
السائدة	Prevailing
تتمكن	Able
ثمن	Eighth
المبحث	Section
بجهود	The
بالتي	Balti
الرسل	Apostles
تطلب	Calls
أسئلة	Questions
شاعر	Poet
والهند	India
الاحتفاظ	Retain
فصول	Chapters
خوف	Fear
تتحول	Turns
مليارات	Billion
الارهابية	Terrorist
العداء	Hostility
المتخصصين	Specialists
وخارجها	And
مسمى	Named
وأصحاب	The
المصرفي	Banking
والمقيمين	And
لسانه	His
المهتمين	Interested
وشمال	And
بقصيدة	Poem
محليا	Locally
الجريمة	Crime
الحساب	Account
ينظم	Regulates
فرعون	Pharaoh
واخراج	And
وابراهيم	Ibrahim
فإنهم	They
صفوفه	Ranks
الريح	Wind
الفحص	Screening
يتعامل	Handles
الأضواء	Lights
شعرت	I
للقوى	Powers
العمرية	Age
والتقاليد	And
واللغة	And
الأخذ	Taking
الحفظ	Conservation
الغزو	Invasion
لأننا	We
تقويم	Calendar
رزقه	Living
المخزون	Stock
مذهب	Doctrine
تسويق	Marketing
سعى	Sought
تمريرة	Pass
بتطوير	Developing
المفوضية	Office
اقرب	The
يفرض	Imposes
بصدد	Process
السورة	Sura
يسهل	Facilitates
الولاة	Governors
البضائع	Goods
المساعدات	Aid
برلين	Berlin
الاولى	First
وبالرغم	Although
سلبية	Negative
عمانتل	Omantel
بالحضور	Attendees
المصريين	Egyptians
نهضة	Renaissance
والشؤون	Affairs
تغلب	Overcome
اليقين	Uncertainty
ميدانية	Field
شبكات	Networks
بطاقات	Cards
الهادي	Pacific
اتفق	Agreed
عدنان	Adnan
الرحلات	Flight
امامه	In
المنصرم	Past
جدد	New
والارشاد	The
صادق	Sadiq
المد	Tide
وبرنامج	The
العلمانية	Secularism
أدب	Literature
كيلومتر	Km
يتطلع	Looks
المبادرات	Initiatives
المستشفيات	Hospitals
والعلمية	And
أستطيع	I
حية	Live
الدعوى	Case
مبني	Built
يأمل	Hopes
والموعظة	The
باول	Powell
اقتصاد	Economics
تخطيط	Planning
الأرضية	Ground
مكاتب	Offices
خسارته	Losing
تتغير	Change
الظهور	Appearing
هيثم	Haitham
هاتين	These
بدائرة	Circle
وطني	The
رأوا	Saw
الضابط	Officer
والتقدم	And
بيسات	Bz
ودخل	And
علامات	Signs
موزعة	Distributed
مفاجأة	Surprise
الفا	Alfa
نحاول	Try
مشواره	His
تبذل	Making
الأسماك	Fish
وصيانة	And
وأحكام	The
للنساء	Women
للمعارض	Exhibition
وضعف	The
المصارف	Banks
أجر	Pay
ويشمل	Includes
الفعلي	Actual
تامة	Total
مصير	The
الارجنتيني	Argentina
حرصا	Order
نظمتها	Organized
وناصر	Nasser
الادبية	Literary
جسد	Body
اوقات	Times
وحيد	Single
تهيئة	Create
مبادرة	Initiative
تترك	Leave
للذين	For
أبطال	Heroes
الضخمة	Huge
ولكنهم	But
لشباب	Youth
حنيفة	Hanifa
تتناسب	Commensurate
آنذاك	Then
تحرص	Keen
القاها	Delivered
سجله	Record
والقدرة	And
والتطور	And
وعقب	Following
العزة	Glory
العقبات	Obstacles
المخطوطات	Manuscripts
الجندي	Soldier
وأكثر	And
التوقعات	Expectations
المرتدة	Apostate
استخدم	Use
اهالي	People
يلزمه	Necessary
المسؤولون	Officials
والمراكز	The
دقة	Resolution
الزمني	Time
يبرز	Highlights
واحة	Oasis
الصداقة	Friendship
زوجة	Wife
حقها	Right
ولهم	And
روحه	Spirit
لاننا	We
ميونيخ	Munich
أربعين	Forty
لاشك	Undoubtedly
ثلث	Third
للحديث	To
الجد	Grandpa
الفردي	Individual
لجامعة	University
التقليد	Tradition
والخبرات	And
الإشراف	Supervision
والهيئات	The
الضباط	Officers
للعاملين	For
استثمارية	Investment
الشاطئ	Beach
جهل	Ignorance
المخ	Brain
زراعية	Agricultural
المطار	Airport
وأبو	Abu
المفتوح	Open
ريالات	SR
نمط	Style
يرتبط	Linked
خديجة	Khadija
بول	Paul
الوظيفة	Position
متمنيا	Wishing
الناقد	Critic
يتغير	Change
وجوده	The
الاصل	Original
صالحة	Valid
زيارات	Visits
آمنة	Safe
الصبي	Boy
الارجنتين	Argentina
اين	Line
واهم	And
بعدا	Dimension
الانعقاد	Reconvene
هشام	Hisham
متتالية	Consecutive
الكفر	Disbelief
اقبال	Iqbal
سقط	Fell
الايدي	Hands
والاستقرار	And
لحل	Resolve
عراقي	Iraqi
وقته	His
السلف	Advances
الدفع	Payment
حذيفة	Hudhayfah
تركيب	Installation
بشرط	Provided
التركي	Turkish
الموجهة	Directed
كلهم	All
الحرفي	Artisan
المصدرة	Exporting
بث	Broadcast
التشكيلة	Squad
وجامعة	University
الخليفة	Caliph
للاطلاع	For
الموافق	Corresponding
أمراض	Diseases
اركان	Staff
أمم	United
فلن	Not
فارس	Fares
جماعات	Groups
إنهم	They
تمهيدا	Prelude
بمكتبه	Received
يطرح	Raises
التغلب	Overcome
مقاومة	Resistance
الحرم	Campus
والفكر	And
أدرك	Realized
الله	God
البريد	E
الكريم	Karim
المميزة	Special
شعب	People
للدخول	To
محافظ	Governor
تحكم	Control
والمهتمين	And
طائفة	Range
فجعل	Making
يسبب	Causing
تمكنت	Managed
اله	God
القيادات	Leadership
بجمهورية	Republic
قاد	Led
لادن	Laden
الشرف	Honor
إيران	Iran
آن	Ann
تارة	Sometimes
بالحق	Right
فتقول	Says
فعلت	Did
الرجوع	Back
الموروث	Inherited
ابراء	Discharge
منازل	Houses
انخفض	Dropped
الجدل	Controversy
نموذجا	Model
خبرات	Experiences
الصحفية	Press
واستقرار	And
اكتساب	Acquire
موظفي	Staff
سهلا	Easy
وظائف	Jobs
الممثلين	Representatives
يناقش	Discusses
القادمين	The
اثار	Raised
للدورة	Session
شر	Evil
لعبت	Played
الاعوام	Past
للرجال	Men
للطالب	Student
سنتين	Two
لاجراء	For
الخيالة	Mounted
الطابع	Character
باعداد	Numbers
بارز	Top
يترتب	Consequent
واختلاف	The
ضيفه	Home
السمع	Hearing
حضورا	Presence
الازمة	Crisis
حديقة	Park
الفضائيات	Satellite
الواسع	Wide
أعتقد	I
لايجاد	To
مقدمتها	Forefront
دراسته	Studied
الجارية	Current
خلقا	Created
المفتي	Mufti
رائعا	Wonderful
واليمن	And
نفذت	Carried
والصناعات	And
للأمة	The
يتخذ	Take
للخروج	Out
أجد	I
إعجاز	Ijaz
شارع	Street
انتاجها	Produced
الايمن	Right
خان	Khan
الاسيوي	Asian
إطلاق	Launch
مادية	Material
اعرب	Expressed
تايوان	Taiwan
والسعي	And
ادت	Led
المسئولون	Officials
والوقوف	And
الصادقة	Sincere
العام	Year
المنافسات	Rivalries
نعمل	Work
لاي	Lai
العوفي	Awfi
مشاركات	Replies
تهتم	Interested
صالة	Hall
رسائل	Messages
المحاولات	Attempts
شمل	Included
ونظام	The
ولبنان	Lebanon
جناح	Suite
ارجاء	Around
ويشير	And
ادراك	Realize
السجل	Record
عم	With
تفرض	Impose
اواخر	Late
الأبيض	White
الدارسين	Learners
احتفالات	Celebrations
الصفا	Safa
العامرات	Amerat
بوضوح	Clearly
تعبير	Expression
اليدوية	Hand
احكام	Provisions
الأساليب	Methods
ارسال	Send
النجمة	Star
النماذج	Models
بر	Barr
والتاريخ	History
والتجديد	And
مسؤولون	Officials
موقعة	Signed
أقيم	Held
ريب	Reap
التطبيقية	Applied
رجب	Rajab
نموذج	Form
الجدار	Wall
الماضيين	Two
حققته	Achieved
تنوع	Diversity
رأسية	Vertical
الفارس	Knight
زراعة	Agriculture
شرب	Drink
والطفل	Child
عال	High
بذلت	Made
يشبه	Like
المدرجة	Listed
التعليمي	Educational
صعبا	Difficult
الإسرائيلي	Israeli
هذا	This
وفرنسا	France
الامسية	Evening
العشرة	Ten
اصول	Assets
للرجل	Men
فريد	Fred
نصب	Monument
نتمنى	Wish
ارضه	Home
جريمة	Crime
المشرفة	Supervising
الاحصائيات	Statistics
سرور	Sorour
الاطلاق	Absolutely
رسالته	His
انتظار	Waiting
مضيفه	Host
نقدية	Cash
أمثال	Like
لقمان	Luqman
الافلاج	Aflac
حافظ	Hafez
مؤكدة	Confirmed
يقدمه	Provided
ومحمود	And
الاستهلاك	Consumption
التضامن	Solidarity
جهودا	Efforts
للشيخ	Sheikh
لاحقا	Later
للحد	To
أيديهم	Hands
شهري	Monthly
وطالبات	And
اللسان	Tongue
فراغ	Vacuum
الفتنة	Sedition
اطلع	View
الاضواء	Lights
مطلوب	Required
المحددة	Identified
لاستضافة	To
تعلمون	You
التقارب	Convergence
العادية	Regular
تشعر	Feel
الصغار	Young
سماء	Sky
بالمملكة	Kingdom
وغرفة	And
الكونغرس	Congress
لحضرة	Hazrat
الصوم	Fasting
الهبوط	Landing
ثمار	Fruits
لرئيس	Prime
يأت	Come
المبالغ	Amounts
متحف	Museum
انتقال	Transmission
المحتلة	Occupied
جان	Jean
ألمانيا	Germany
الإسلامية	Islamic
جنيه	£
البعيد	Remote
البعث	Baath
أطلق	Launched
الجماعية	Collective
قديما	Past
تحديات	Challenges
الزوجية	Marital
والادارية	And
رع	Ra
تجرى	Conducted
فرانكفورت	Frankfurt
قياس	Measuring
حياتي	My
جبال	Mountains
الحية	Live
ظلم	Injustice
النقص	Shortage
الوجوه	Faces
مشاركتها	Participation
للمنظمة	Organization
انفجار	Explosion
كشفت	Revealed
للمؤمنين	For
متن	Board
المبنى	Building
شهدتها	Witnessed
أموال	Funds
يجعلنا	Us
ضعيفة	Weak
التصويت	Voting
العائلة	Family
للخيول	For
ابرزها	Namely
الكروي	Spherical
زعيم	Leader
يمكننا	We
والقطاع	The
تركت	Left
ماليزيا	Malaysia
الحصان	Horse
بروح	Spirit
التراجع	Retreat
الاستعانة	Use
ودون	And
بالقول	Saying
ركب	Rode
لاستقبال	To
واختيار	And
وقسم	And
ينزل	Descends
رحيم	Rahim
قادمة	Coming
الموحدة	Standard
ولله	And
الزوجة	Wife
فإننا	We
تتابع	Relay
مشروعا	Project
اقامتها	Hosted
لأنشطة	For
وتحت	Under
الوزاري	Ministerial
القراء	Readers
الغافري	Ghaferi
الهدى	Huda
هائلة	Huge
الوليد	Alwaleed
فنجد	We
هجمة	Onslaught
الحضرمي	Hadrami
أفغانستان	Afghanistan
مواكبة	Keep
المنتظر	Expected
فتاة	Girl
فريقي	Panels
للمنطقة	Area
محدد	Set
لدرجة	To
نسبيا	Relatively
تأثر	Affected
وقدمت	And
وسدد	And
بعبري	Ibri
لحضور	To
أحدهما	One
ترتفع	Rises
الإقليمية	Regional
المبكر	Early
نال	Received
أنفسكم	Yourselves
لزيارة	To
حققها	Achieved
البطاشي	البطاشي
تدريجيا	Gradually
أعداد	Numbers
المرضى	Patients
تأمل	Hopes
ابنة	Daughter
عنك	You
فسوف	Will
موت	Death
التسهيلات	Facilities
نتاج	Product
بحوالي	About
أجمل	Beautiful
العفو	Amnesty
الخصائص	Characteristics
توضيح	Clarify
وتعمل	And
هاني	Hani
خلفه	Behind
بالمحافظة	Maintaining
التكاليف	Costs
السرية	Secret
والزراعة	And
الساحلية	Coastal
وتبقى	The
انتقل	Moved
الحلقات	Rings
المدة	Duration
مقابلة	Interview
قرأ	Read
التغيرات	Changes
العضوية	Member
ملف	File
المتوسطة	Medium
الانظمة	Systems
لعلكم	You
الترجيح	Weighting
ويوجد	There
نشأت	Originated
والتعريف	The
المصطلح	Term
مدن	Cities
الاستخدام	Use
مطالبة	Claim
سددها	Shot
الاستئناف	Appeal
جعلها	Make
نجحت	Succeeded
الأقصى	Far
الكرام	Dear
دوائر	Circuits
مؤشرات	Indicators
التوزيع	Distribution
عليم	Knowing
واقعية	Realistic
موسيقى	Music
وطلب	Asked
المفترض	Supposed
لمعالجة	To
الطاولة	Table
قرابة	Nearly
تظل	Remain
المؤقتة	Temporary
تألق	Shine
لالعاب	Games
حواجز	Barriers
مبكر	Early
المحطة	Station
يمشي	Walking
حادث	Accident
المرسوم	Decree
والعالمية	The
إصدار	Issue
توصل	Reach
بالعاصمة	Capital
العجمي	Ajami
يتولى	The
لوجود	The
أهلها	People
عميق	Deep
التوعوية	Awareness
دورية	Patrol
عرفت	Known
الظواهر	Phenomena
زين	Zain
عرضها	Displayed
العمري	Age
أعطى	Gave
علامة	Mark
الأسعار	Price
للدور	The
قصائد	Poems
البصري	Optical
وقتا	Time
عناية	Care
أخرج	Out
انكلترا	England
تركه	Leaving
المخيم	Camp
السيئة	Bad
حاولت	Tried
الدقيق	Flour
المتدربين	Trainees
جدير	Worth
والتأهيل	And
عمليا	Practically
حوض	Basin
جانبا	Aside
الجنرال	Gen
وجوب	Should
النشرة	Bulletin
تنتج	Produces
المسائية	Evening
محادثات	Talks
الخلايا	Cells
يسبح	Swim
الأولمبي	Olympic
للحفاظ	To
وتقام	And
أدنى	Minimum
السد	Dam
التوسع	Expansion
خارطة	MAP
نوعها	Kind
فنان	Artist
الغناء	Singing
وترى	And
الستار	Curtain
ولكي	To
حيا	Alive
طائرة	Plane
الستة	Six
لرفع	To
ترأس	Presided
الواردات	Imports
واحد	One
انعقاد	The
دائمة	Permanent
المعولي	Mawali
نبيه	Nabih
بالمشاركة	Participate
أسبوع	Week
السجن	Jail
امن	Security
سار	Sar
تحقيقها	Achieved
وخرج	And
الناشئين	Junior
ذهابا	Round
الأهلية	Civil
الشابة	Young
خصوصية	Privacy
فله	He
اعتقال	Arrest
دل	Del
وهؤلاء	Those
شهرين	Months
أعماق	Depths
البطل	Hero
عقبة	Obstacle
باتت	Now
وحقوق	The
مناسب	Appropriate
يصح	True
قلنا	Said
والثلاثين	Thirty
الكنيسة	Church
دورته	Its
اعطى	Gave
لمحمد	Mohammed
ودول	States
الاحمر	Red
لعملية	To
التقني	Technical
العميد	Brigadier
تلقي	Receive
سهولة	Ease
قط	Never
وذات	And
ناقشت	Discussed
صلاته	Links
المصاحبة	Accompanying
لسوق	Market
النوعية	Quality
حقيقي	Real
يختار	Choose
ورأى	And
وتقييم	And
دقيق	Flour
الكائنات	Objects
وحفظ	And
وصفه	And
طفل	Child
وفعاليات	And
تسمع	Hear
اشجار	Trees
المحبة	Loving
اللطيف	Latif
تنويع	Diversification
عبده	Abdo
مميزة	Featured
حلم	Dream
وحسين	And
الباطل	Falsehood
عربيا	Arab
ويتضمن	Includes
قلق	Concern
الأوضاع	Conditions
بالدور	Role
تصحيح	Correct
أقصى	Maximum
الأسر	Families
معروفة	Known
للدكتور	Dr
فكرية	Intellectual
الرياح	Wind
الإعلامية	Media
المعاقين	Disabled
ودفع	And
الأردنية	Jordan
لاختيار	To
جواز	Passport
الميثاق	Charter
الغزالي	Ghazali
التخصيص	Customization
ادخال	Insert
الأماكن	Places
لحقوق	Human
عواصم	Capitals
وفازت	And
مفتوح	Open
بالضرورة	Necessarily
للدفاع	To
لعل	Perhaps
تولى	Took
يتصل	Related
ا	A
مباراتين	Two
صاحبها	Owner
السلاح	Arms
حث	Urged
لمثل	Like
ويعود	And
القادة	Leaders
نبي	Prophet
موسكو	Moscow
عصرنا	Our
والجهات	The
تستضيف	Hosts
بالمدرسة	School
الدهر	Age
مخالفة	Contravention
كيلومترات	Kilometers
وقامت	The
حظيت	Received
إنجاز	Completion
التام	Full
أميركية	US
بدخول	Enter
وعضو	And
المستشار	Chancellor
الأجيال	Generations
المعالجة	Processing
بجروح	Wounded
الأمية	Illiteracy
التيار	AC
التميز	Excellence
الفاعلة	Actors
الضيف	Guest
الممارسات	Practices
الكهربائي	Electrical
الجمركية	Customs
الطلاق	Divorce
العارضة	Crossbar
بالفكر	Thought
وأي	Any
99	
للبحث	Search
المتسابق	Racer
المنشود	Desired
تفتح	Open
الكوري	Korean
والكليات	And
بانشاء	Establishment
بغية	To
وكلما	Whenever
نطفة	Sperm
الناخبين	Voters
وتطبيق	And
عندنا	We
بقيت	Remained
الجمع	Combined
مفاهيم	Concepts
ومعه	And
الاربع	Four
شهادات	Certificates
القربى	Kin
اللائحة	Regulation
وتوزيع	And
ينجح	Succeed
غضب	Anger
وبيان	Statement
اجتماعه	Its
المثقفين	Intellectuals
المرشح	Candidate
بالدرجة	Class
ديوان	Office
النقاش	Discussion
الحجري	Stone
الصيام	Fasting
التقوى	Piety
والعلاقات	Relations
فعالياته	Its
وجدنا	We
تتيح	Allow
اختلف	Differed
ضم	Included
قرارا	Resolution
ونتمنى	And
اشاد	Praised
الخضراء	Green
الاصلي	Original
واعتقد	I
المعلومة	Information
الارشاد	Extension
تشهدها	Witnessed
للجمهور	To
وتعادل	And
عاملا	Factor
الطموح	Ambitious
الروائي	Novelist
الحيوان	Animal
تثبت	Prove
العالمى	World
سيطرة	Control
وفريق	And
ليلا	Night
مبالغ	Amounts
أيدي	By
الميداليات	Medals
القطع	Cutting
احيانا	Sometimes
رأينا	Saw
تحولت	Turned
الاثار	Antiquities
تكرار	Repeat
تبرز	Stand
بجائزة	Award
ويذكر	The
الخلافة	Caliphate
الحزن	Sadness
نقرأ	Read
وضمن	And
الانتشار	Proliferation
يركز	Focuses
الرامية	Efforts
صفر	Zero
معارض	Shows
انت	You
أسلحة	Weapons
سد	Dam
المبدع	Creator
قدمتها	Provided
توقع	Predicted
للمباراة	The
يعرفون	Know
فلسفة	Philosophy
مذكرة	Memorandum
والندوات	And
بالاتحاد	Union
إجراءات	Procedures
صغير	Small
جعله	Make
لتحسين	To
القتال	Fighting
مرماه	OG
المعالي	Excellencies
أكتوبر	October
سبحان	Glory
طرف	Party
جعفر	Jaafar
شوقي	Shawki
بطلة	Champion
أساسية	Basic
الكرات	Balls
الحجم	Size
زار	Visited
أندية	Clubs
الوادي	Valley
ضباط	Officers
التدريبي	Training
ولكننا	But
والقوانين	The
وارتفاع	High
القارة	Continent
الميلاد	Birth
يبين	Shows
دليلا	Proof
مفاوضات	Negotiations
المخدرات	Drugs
تواجد	Seen
أركان	Staff
الامطار	Rain
ديفيد	David
الإصلاح	Reform
قادرا	Able
توضح	Describes
بجنوب	South
نهى	Forbade
ترد	Received
ناقش	Discussed
شاهد	Show
المدربين	Trained
عرضت	Offered
اقتصادي	Economic
وكانوا	And
جاك	Jacques
جندي	Soldier
العثور	Found
شيء	About
اشخاص	People
راحة	Comfort
مرتفعة	High
الرحيم	Rahim
الهدايا	Gifts
تاريخه	History
المقبالي	Almkabbala
بغض	Regardless
دوما	Always
قضاء	Spend
تتخذ	Take
بحجة	Pretext
بطولات	Tournaments
العاص	Aas
الذهنية	Mental
استعمال	Use
يقود	Lead
الالكتروني	Mail
بالنادي	Club
يدعون	Call
المباني	Buildings
خصص	Allocated
صالحا	Valid
الضائع	Lost
الحياتية	Life
للولايات	States
اى	Any
القليل	Little
ثقافي	Cultural
بمجرد	Once
يخوض	Running
تردد	Frequency
الأوقاف	Endowments
الاتحادات	Unions
وروى	And
المثل	Ideals
ومدير	And
فروع	Branches
تسهيل	Facilitate
التكلفة	Cost
المدعي	Prosecutor
والعالم	The
الاستشارية	Advisory
الطائرات	Aircraft
الاساليب	Styles
اعوام	Years
تبذلها	Made
المقصود	Intended
المقومات	Constituents
العريقة	Ancient
أمية	Illiteracy
شرط	Clause
الزاوية	Angle
إخراج	Output
وآله	And
اسماء	The
المعشري	Almashra
عظيما	Great
الذنوب	Sins
ضرب	Hit
والآخرة	And
الانفجار	Explosion
عالمي	Global
المعالم	Monuments
السودانية	Sudan
اليومي	Daily
والعطاء	The
مماثلة	Similar
معاوية	Muawiya
تفعل	Do
للاقتصاد	Of
والواقع	Indeed
عزت	Izzat
الربط	Linkage
الاحيان	Times
التجمع	Assembly
جهنم	Hell
طرد	Expelled
الصالحين	Righteous
وفاته	His
السابقين	Ex
الحذر	Caution
الخيال	Fiction
الوافدين	Arrivals
التجار	Traders
الثقافات	Cultures
البيئي	Environmental
لاعادة	Re
بالمقابل	Conversely
الطلبات	Applications
العطية	Attiyah
يحظى	Has
يفتتح	Opens
سياسي	Political
أنفسنا	Ourselves
المجموعات	Groups
شاطئ	Beach
انجازات	Achievements
الأكثر	Most
مكانا	Place
طواف	Cruising
الديون	Debt
ص	P
فإنما	I
اسرة	Dynasty
المصانع	Factories
صار	Became
والمواد	Articles
ينتج	Produces
يمكنه	Can
الشهادات	Certificates
السبع	Seven
سلوك	Behavior
العقاري	Real
الطفولة	Childhood
الملتقيات	Forums
يمتلك	Owns
حرصت	Keen
التوجيهات	Directives
صيانة	Maintenance
البسيطة	Mini
بالهيئة	Authority
عرفة	Arafa
يستخدم	Uses
يعلمون	Know
الشيوخ	Senate
عراقية	Iraqi
تخفيض	Reduction
احدث	Latest
زمنية	Time
اختار	Chose
حدد	Select
الميزانية	Budget
الإسرائيلية	Israeli
الأمنية	Security
بنية	Structure
الوافدة	Incoming
القرون	Ages
المعسكرات	Camps
المفكرين	Thinkers
أحدث	Latest
اسلامية	Islamic
ناجحة	Successful
القاء	Shed
ركن	Corner
باستثناء	Except
هدفه	Target
لمهرجان	Festival
انور	Anwar
بطن	Belly
والثالث	And
الطواف	Circumambulation
الجملة	Wholesale
بصحار	Sohar
التقليدي	Traditional
العيون	Eyes
للامم	UN
لشئون	Affairs
فتنة	Fitna
اشارة	Signal
مسار	Path
أسواق	Markets
الاذاعة	Radio
وكأن	As
شعراء	Poets
تبني	Build
الأمين	Secretary
إبراز	Highlighting
وتحديدا	Namely
المقدم	Submitted
مطر	Matar
القلم	Pen
الرأس	Head
يجيب	Answers
الايجابي	Positive
حسنة	Well
الأخبار	News
بالمستوى	Level
يحرص	Keen
عليهما	Them
اسس	Foundations
العظيمة	Great
يضمن	Ensures
بخصوص	About
اخي	Only
سياق	Context
يوصي	Recommends
جمهور	Audience
عقده	Held
والاطلاع	And
الظهر	Back
مثال	Example
والده	His
أكدت	Confirmed
حكما	Sentenced
المتميزين	Outstanding
خوفا	Fear
الصحراء	Desert
السمكي	Fish
السكانية	Population
القريبة	Near
كونا	Kuna
بسوق	Market
ونتيجة	As
بحد	Up
الوالدين	Parents
الفرحة	Joy
الجوفية	Groundwater
السباحة	Swim
الشريفة	Honorable
فندق	Hotel
الأخطاء	Errors
الإصابة	Injury
وتهدف	The
الجامعية	University
سرية	Secret
سكنية	Housing
تخصص	Allocate
اعماله	Its
فجر	Dawn
الدعاء	Supplication
للطلبة	Students
شوط	Run
الزوج	Pair
وعلم	And
فرحة	Joy
برنامجا	Program
ابراز	Highlight
تستهدف	Target
نموا	Growth
ويسعى	Seeks
تاريخها	History
يميز	Distinguishes
تقدمت	Made
بالعدل	Justly
شرائح	Segments
المراعي	Pasture
صهوة	Horseback
اولئك	Those
مناهج	Approaches
الفضاء	Space
الهيئات	Bodies
نالت	Gained
تقسيم	Division
تقنيات	Techniques
سئل	Asked
الموجود	Located
سأل	Asked
بفوزه	Winning
محو	Erase
يلزم	Required
بالتأكيد	Certainly
العربي	Arab
سريعا	Fast
النائب	MP
العقوبات	Penalties
المساواة	Equality
طه	Taha
قاله	Said
رر	PL
بحرية	Freely
أوراق	Papers
العائد	Yield
عطاء	Ata
عجز	Deficit
بطبيعة	Naturally
هولندا	Netherlands
و	And
محلية	Local
متميز	Privileged
الثابت	Hard
الحين	Then
وأهل	And
تحققت	Achieved
عظمة	Greatness
رصد	Monitoring
الطين	Mud
اضاف	Added
العادة	Usually
أخيه	His
النظم	Systems
والصين	China
تشهده	Witnessed
محفوظ	Mahfouz
للعالم	For
الثورة	Revolution
ويتوقع	The
الراحة	Comfort
أقوى	Stronger
قائم	Based
تحظى	Are
الرباط	Rabat
الأمل	Hope
والجبال	And
المعتمدة	Approved
وبهذه	In
الجنس	Gender
يأكل	Eats
تقتصر	Limited
وأضافت	The
ومكان	And
الأردن	Jordan
إننا	We
وسوريا	Syria
صرف	Exchange
واوضحت	She
بذكر	Remembrance
الرئاسية	Presidential
قوى	Forces
التفاعل	Interaction
صدرت	Issued
المعوقات	Constraints
ويعمل	And
متكامل	Integrated
محلات	Goods
بإذن	Permission
المخلفات	Residues
المعاملة	Treatment
يستفيد	Benefiting
مثله	Like
ويقدم	And
أغلب	Most
تزخر	Replete
والدليل	Proof
المائدة	Table
بزمن	A
التحتية	Infrastructure
الدستور	Constitution
محافظات	Governorates
السماح	Allowing
مايكل	Michael
بمدرسة	School
وصور	Photo
يرغب	Wish
الولد	Boy
سنغافورة	Singapore
والوافي	And
دام	Lasted
ثمرة	Fruit
الاتجاهات	Trends
حج	Ag
الرماية	Shooting
صباحا	Am
والسياحة	And
وتضيف	And
مخرج	Exit
الأخضر	Green
لمنظمة	Organization
النسائية	Women's
حملت	Loaded
الفتح	Conquest
انسان	Man
يورو	EUR
بركة	Pond
مرتبطة	Linked
سندا	Bond
الاقبال	Turnout
ونقلت	Quoted
والشباب	The
القصائد	Poems
يهدي	Guides
الوحدات	Units
الميدان	Field
ونأمل	We
عملهم	Their
عقله	His
فعله	Do
سفر	Travel
أدت	Led
الرائعة	Magnificent
محدودة	Limited
سفيان	Sufian
الروحية	Spiritual
الواسعة	Wide
تايلاند	Thailand
والنساء	And
الاحكام	Conditions
آفاق	Horizons
الجماعات	Groups
الهجن	Camel
يرون	See
ينطلق	Off
التمييز	Discrimination
للتدريب	Training
محكم	Arbitrator
التركية	Turkish
المولى	Mawla
ادار	Refereed
تعنى	Means
سهيل	Sohail
اتخذت	Taken
المذكورة	Mentioned
استراليا	Australia
والسياسية	And
يموت	Die
ومنطقة	And
اتفاقيات	Conventions
تنظمه	Organized
ساعد	Helped
الراهن	Current
زوار	Visitors
بفعل	By
بعين	Into
ورؤساء	And
المقدس	Bible
فيهما	Two
داخلية	Internal
نعيش	Live
لكأس	Cup
استعداد	Ready
شخصيات	Figures
المحدد	Specified
الجاهلية	Ignorance
كليات	Colleges
تابع	Continued
طبيعي	Normal
سباقات	Racing
بنادي	Club
استكمال	Complete
صعب	Saab
معي	Me
الغضب	Anger
حدثت	Occurred
المنطلق	Vein
المنتجة	Produced
اساليب	Methods
قصص	Stories
إمكانية	The
بالولايات	States
نظيفة	Clean
عدو	Enemy
المتغيرات	Variables
ودورها	And
الاثرية	Archeological
يربط	Connecting
اقبالا	Turnout
المفتوحة	Open
المحادثات	Talks
للرئيس	President
الفقرات	Paragraphs
وكنت	I
فعن	Narrated
قبيلة	Tribe
الوثيقة	Document
للحكومة	Government
والسعادة	And
يحج	Pilgrimage
النوم	Sleep
الروحي	Spiritual
الأحيان	Often
ومثل	And
تحتوي	Containing
نصر	Nasr
مصطلح	Term
يتضح	Clear
صراع	Conflict
يؤمنون	Believe
المخصصة	Allocated
الاثر	Impact
الذاكرة	Memory
لتنظيم	To
التصور	Visualization
سمع	Heard
تعيين	Set
الإنسان	Rights
الكعبة	Kaaba
الحروب	Wars
والاقتصاد	And
نار	Fire
الآداب	Arts
ترجع	Returns
والسمكية	Fish
مولانا	Maulana
كسب	Earn
ضخمة	Huge
يسجل	Score
القتل	Killing
السريعة	Fast
اساسية	Basic
عقل	Mind
المناسبات	Events
القياسي	Record
استثمار	Invest
الشخصي	Profile
التحرير	Liberation
والتقدير	And
مسائل	Issues
ينتهي	Ends
بالقطاع	Sector
نسخة	Copy
فأين	Where
وتطرق	Turning
قديمة	Old
رسوم	Fees
الأحاديث	Conversations
الاجمالي	Total
المذهب	Doctrine
تصميم	Design
الختامي	Final
اية	State
وتشمل	Include
واما	And
بلير	Blair
تنظر	Consider
الإجراءات	Procedures
اضافية	Additional
الميناء	Port
العملي	Practical
الاقليمي	Regional
المتحف	Museum
تمتلك	Owns
يقضي	Spend
توصيل	Connecting
الاساس	Foundation
مجالس	Councils
مشاهد	Scenes
يوضح	Shows
جسم	Body
هوية	Identity
تحسن	Improved
مكانه	Place
استعدادات	Preparations
وفتح	The
ينتقل	Turns
نذكر	Recall
حديد	Iron
شرعية	Legitimacy
زميله	Colleague
لها	Her
الأساس	Base
الرئاسة	Presidential
لهؤلاء	Of
الأجر	Pay
سلطة	Authority
الأشخاص	People
أماكن	Places
جمعت	Collected
والشيخ	Sheikh
الحنيف	True
الغالية	Dear
آليات	Mechanisms
تشتمل	Include
التقت	Met
اللازم	Required
السعر	Price
آمن	Safe
ينفع	Benefit
للمجتمع	Community
يسبق	Preceded
منظومة	System
بأكثر	More
واصبح	And
المتوفرة	Available
الرستاق	Rustaq
الدائمة	Standing
الحديد	Iron
واصل	Continued
البديل	Alternative
الأفضل	Best
خصب	Khasab
مجريات	Happenings
تقرأ	Read
النطاق	Range
السفارة	Embassy
فاننا	We
بالذات	Precisely
سيقوم	Will
الأدبية	Literary
المكرمين	Honorees
بلوغ	Reach
تضمنت	Included
يشتمل	Includes
الفضائية	Space
والقرآن	The
ستقوم	Will
وطالبة	The
الغير	Others
نسعى	Seek
الفطرة	Instinct
الاجنبي	Foreign
قمنا	We
دنيا	Minimum
وحدات	Units
اصابة	Injuring
لقول	To
أزمة	Crisis
توصيات	Recommendations
ضبط	Set
ربكم	Lord
الخصوص	Particular
مشهد	Scene
كفروا	Disbelieve
الصعبة	Difficult
ونجح	And
وفيها	And
والسلامة	And
تحدثت	Spoke
بيوم	Day
رالي	Rally
وصولا	Down
فبعد	After
تراب	Dust
يرفع	Raises
تستضيفها	Hosted
وولايات	And
بيده	His
التليفزيونية	TV
ونشر	The
العلامة	Mark
لأنهم	Because
السياق	Context
مصالح	Interests
زوجته	His
للمناطق	Areas
وتدريب	And
الاختصاص	Jurisdiction
مالي	Mali
أنس	Anas
كرم	Karam
الادبي	Literary
عندي	I
والبحوث	And
سلبا	Negatively
الثابتة	Fixed
بدرجة	Degree
شعبية	Popular
نشرت	Published
الحجاب	Veil
والبعض	Some
يستحق	Worth
تحقيقه	Achieved
المدونة	Blog
كميات	Quantities
شجرة	Tree
ثلاثين	Thirtieth
وبيع	The
العالم	World
لشؤون	For
السبق	Lead
الاماكن	Places
خليل	Khalil
والانشطة	And
فنجاء	Fanja
الاسلوب	Style
أمل	Amal
بأعمال	Work
للشرطة	Police
امتداد	Extension
جبريل	Jibril
يتيح	Allows
الدرس	Lesson
العادات	Habits
واعادة	And
وانشاء	Generation
تحصل	Get
بالفوز	Winning
العقلية	Mental
سطح	Surface
والدول	States
المسؤولية	Responsibility
تنشيط	Activate
استضافة	Host
تسديدة	Shot
الترفيهي	Entertainment
انطلق	Off
بالغة	Extremely
آياته	Verses
مازالت	Still
قائما	Stand
فنيا	Technically
للناشئين	U
الاميركى	US
مطار	Airport
وقوة	The
مشيرة	Noting
تقرر	Decides
جنود	Soldiers
وشهدت	And
جدوى	Feasibility
باللقب	Title
عامي	Ami
والسعودية	And
ومسلم	Muslim
التوجيه	Directive
برشلونة	Barcelona
الصادق	Sadiq
إسماعيل	Ismail
وعبر	And
يفتح	Open
ضغط	Pressure
هام	Ham
وحدها	Alone
الاغلاقات	Closures
التفتيش	Inspection
كمال	Kamal
اعلان	Advertising
الايجابية	Positive
تسمح	Allow
يتعين	To
الترويج	Promotion
الجلد	Skin
الاسمنت	Cement
وكتاب	The
تأمين	Insurance
شباك	Box
تعدد	Multiplicity
صدارة	Top
جاسم	Jassim
البصرة	Basra
مملكة	Kingdom
مشكلات	Problems
حجر	Stone
تسمى	Called
أكون	I
الجمعيات	Societies
الامكانيات	Possibilities
للطلاب	Students
الترمذي	Tirmidhi
السبل	Ways
المحطات	Stations
لائحة	List
طن	Tonnes
السامي	High
قضى	Spent
وصرح	Said
مديري	Managers
الجليل	Galilee
الكل	Total
ويبدو	It
انك	You
تعليمية	Educational
للشركات	Companies
وشركة	The
حولها	Around
الديمقراطي	Democratic
أني	I
التزام	Commitment
علمه	Knowing
المدافع	Defender
سهل	Easy
الباكستانية	Pakistan
قيم	Values
تضع	Put
خطاب	Speech
الملابس	Clothing
اماكن	Places
التراب	Dirt
احسن	Best
قريبة	Close
شكلت	Formed
عندهم	Have
يونايتد	United
يتمثل	Is
دينهم	Religion
بثلاثة	Three
يضيف	Adds
احرز	Scored
وايران	And
بمثل	Such
تدريبات	Exercises
مبارياته	Matches
مبكرا	Early
الأحوال	Conditions
الشهير	Famous
ولماذا	Why
بخلاف	Than
الزائر	Visiting
يصعب	Difficult
نظرية	Theory
موافقة	Approval
ويستمر	And
مقبول	Acceptable
نبيل	Nabil
الميمني	Maimani
سلطنة	Sultanate
العقلي	Mental
يعكس	Reflects
وتراجع	And
محور	Axis
الفضية	Silver
وحماية	And
بصور	Images
السلبي	Negative
لدراسة	To
لمختلف	For
ولكل	And
باعتبار	As
الهوية	Identity
اميركية	US
الرائع	Magnificent
والكتاب	The
مفتوحة	Open
التسامح	Tolerance
القطاعين	Sectors
والفنون	The
عملي	My
سمير	Samir
عندها	Then
مهام	Tasks
العمومية	Sheet
منتجات	Products
للسيارات	Car
الصدق	Honesty
وأخرى	The
الكاميرون	Cameroon
تدفع	Pay
وآخر	The
لادارة	Management
اللواتي	Who
معاملة	Treatment
الفعل	Verb
جهدا	Effort
بنهاية	End
التنظيمية	Regulatory
وانها	And
يسهم	Contribute
ومصر	Egypt
الحرارة	Heat
جدة	Jeddah
فيكون	Shall
بحكم	Ex
والمشاريع	And
خفض	Cut
تنفيذه	Executed
نأخذ	Take
التدريبات	Exercises
مد	D
وتفعيل	And
منزل	HOME
وبعدها	And
الافراد	Individuals
حكومية	Governmental
بيوت	Houses
وضعها	Placed
النشر	Publication
فيتنام	Vietnam
الافلام	Movies
ذاك	That
القبائل	Tribes
يحق	Entitled
المؤشر	Index
السفينة	Ship
الاجانب	Foreigners
سلمان	Salman
أساليب	Methods
ظلمات	Darkness
منصب	Position
مستقلة	Independent
للانسان	For
أعلنت	Announced
حصر	Inventory
التشريعية	Legislative
والاتحاد	Union
تتوفر	Available
الفهم	Understanding
الحيوي	Dynamic
والعقل	And
رؤوس	Capital
عرضه	Display
فذلك	That
مراجعة	Review
قاسم	Qasim
فترات	Periods
البرازيل	Brazil
القبول	Admissions
بجوار	Next
والحقيقة	In
بدية	Bidiya
الحر	Free
يحتوي	Contains
اللوحات	Paintings
قتلوا	Killed
نزول	The
الجماعي	Collective
فماذا	What
ومناقشة	And
ويهدف	Aims
إلينا	Us
اصل	Out
مدربه	Coach
هدفين	Two
للتعرف	To
اعطاء	Give
جزيرة	Island
امل	Amal
ضيق	Narrow
المهام	Tasks
الاسر	Families
والبحرين	Bahrain
فلقد	Has
تسليم	Delivered
الضمان	Warranty
جميعها	All
المفكر	Thinker
الشوارع	Streets
الامتحان	Exam
الآراء	Consensus
يكشف	Reveals
بموجب	Under
المؤتمرات	Conferences
توظيف	Hire
المركبات	Vehicles
وعي	Awareness
القضاة	Judges
حياتها	Her
المتابعة	Followup
المرشحين	Candidates
مرهون	Depends
الشرب	Drinking
الانفاق	Spending
ومعرض	Gallery
الاتفاقيات	Agreements
رئاسة	Presidency
فقط	Only
يفهم	Understand
نعلم	Know
يتوقف	Stop
الفلسفة	Philosophy
الأحزاب	Parties
أمامه	In
والعربية	English
الناجحة	Successful
الموافقة	Approved
توعية	Awareness
وتأهيل	And
الخيل	Horse
توحيد	Unify
وسبل	And
موارد	Resources
المناخ	Climate
والمكان	And
وبدر	Badr
نأمل	Hope
طلبات	Requests
متكاملة	Integrated
القلق	Anxiety
بافتتاح	Opened
فلان	SMB
تسعة	Nine
طهران	Tehran
التونسية	Tunisian
وحب	Love
اخراج	Directed
عمق	Depth
قدره	Of
الاغذية	Food
بملعب	Stadium
الفقهية	Jurisprudential
الأنبياء	Prophets
قصد	Inadvertently
السر	Password
معايير	Standards
مركزا	Center
شاب	Young
سحب	Withdraw
الشاطئية	Beach
تتواصل	Continue
التاريخي	Historic
والتجارة	And
وحصلت	And
بحلول	By
تمتد	Stretching
القطرية	Qatar
وأصبح	And
كاملا	Full
المحاور	Axes
طيلة	Over
اتصال	Contact
يراه	Sees
الشعري	Poetic
عضوا	Member
والتجارية	And
النقاد	Critics
الخريجين	Graduates
منصور	Mansour
الاردني	Jordan
ونصف	And
بتاريخ	On
الكثيرة	Many
سي	C
الأولمبية	Olympic
الاحوال	Case
قليل	Few
الاستعدادات	Preparations
ومؤسسات	And
وتحدث	Speaking
حكمة	Wisdom
حرام	Haram
مبادئ	Principles
مقام	Maqam
وتشير	The
الأجنبية	Foreign
أحكام	Provisions
معركة	Battle
الأصل	Original
العريمي	Araimi
بالجامعة	University
الرسائل	Messages
يحدد	Identifies
ألفا	Alpha
الافكار	Ideas
الانتقال	Jump
المستجدات	Developments
شكر	Thanked
ونظرا	Given
الحل	Solution
السندات	Bonds
معلم	Teacher
المصالح	Interests
بشدة	Strongly
بالطبع	Course
الاعلامي	Media
الفئات	Categories
قدما	Forward
بتكلفة	At
المدرسي	School
تتعرض	Exposed
العاشرة	X
تعقد	Hold
ذهبت	Went
رضوان	Radwan
لدور	The
بعملية	Process
التسويق	Marketing
للتجارة	Trading
أحدهم	One
موجود	Existing
وتعد	The
تتجاوز	Exceed
الاكاديمية	Academy
آراء	Views
سقف	Roof
منطلق	Out
تتراوح	Range
مشترك	Joint
وسنة	Year
أفريقيا	Africa
المعوقين	Disabled
المجيد	Majeed
لمناقشة	To
الضروري	Necessary
بمن	Including
قدرته	Its
أخذت	Took
الجميل	Beautiful
لويس	Louis
طابع	Character
واخرى	And
المراقبة	Monitoring
الامل	Hope
طيب	Tayyip
والتطوير	And
الميدالية	Medal
معروف	Unknown
قرارات	Resolutions
بأس	Quite
البستان	Bustan
الغرض	Purpose
الفضل	Credited
خلقنا	Created
سدد	Paid
يقيم	Assesses
قناة	Channel
الاسم	Name
ويبلغ	The
المعاملات	Transactions
يتبين	Found
اليسرى	Left
دلالة	Denote
الأفراد	Individuals
بلدة	Town
تتبع	Track
فيجب	Must
لكننا	But
والمحافظة	And
متقدمة	Advanced
المرجوة	Desired
واعداد	The
قرى	Villages
يعنى	Means
الصعود	Climb
ابنه	Son
فعليه	He
طبقا	According
بكم	You
العمل	Work
يتكون	Consists
الطلابية	Student
صدره	Chest
سألت	Asked
الشعور	Feeling
كلم	Km
واستخدام	And
المتواصل	Continuous
بدا	Appeared
وترك	And
اشتملت	Included
رئيسا	Head
الفوائد	Benefits
العذاب	Torment
والحديث	The
رأسها	Head
لمسابقة	Competition
الاجمالية	Total
بمكتب	Office
القمر	Moon
والامارات	The
كأن	If
حقل	Field
الاوقاف	Endowments
لنقل	To
وقطر	Qatar
التشغيل	Operating
المشرق	Mashreq
صحي	Healthy
استمر	Lasted
انجاح	The
الحروف	
مانشستر	Manchester
زيارته	His
قادة	Leaders
باتجاه	At
يسأل	Asks
الاختلاف	Difference
ارتفاعا	Up
تمويل	Financing
الاطراف	Parties
ويبقى	And
بوضع	Put
تنتهي	Ends
المقدسة	Holy
السنين	Years
محاضرات	Lectures
مستشار	Advisor
عنصر	Element
التنوع	Diversity
غريب	Ghraib
رشيد	Rosetta
المحيطة	Surrounding
تسير	Going
مواضيع	Threads
الاخرين	Others
لشركة	Company
متوسط	Average
التأهيل	Rehabilitation
كتابا	Book
الطبي	Medical
الاصلاح	Reform
سيقام	Will
ملامح	Features
الجزائري	Algerian
ليبيا	Libya
فنون	Arts
امور	Things
قيد	Under
كتبت	Started
طالبان	Taliban
تتكون	Composed
الألعاب	Games
والخاصة	And
الأقل	Least
تكنولوجيا	Technology
وعرض	Displaying
تجدر	Worth
النظافة	Hygiene
اكدت	Confirmed
افغانستان	Afghanistan
وادارة	And
اليهم	Them
شارون	Sharon
يتميز	Features
مشاعر	Feelings
المخابرات	Intelligence
حلول	Solutions
لتعزيز	To
وفاة	The
الجدد	New
المحروقي	Mahrouqi
بانها	As
شامل	Comprehensive
رسوله	Messenger
ابدا	Never
صدور	The
المحاضر	RECORDS
الأثر	Impact
موضوعات	Topics
لست	I'm
أشياء	Things
يسمع	Heard
سلم	Him
أخرى	Other
الجزاء	Box
اسبوع	Week
الثنائية	Bilateral
تكاليف	Costs
النية	Intention
والنصف	And
الصبر	Patience
ولها	And
الهاشمي	Hashemi
شدة	Intensity
عامين	Two
وبدأت	And
محمدا	Muhammad
يعطى	Given
متخصصة	Specialized
للإسلام	Of
القروض	Loans
التكامل	Integration
بتكريم	Honored
تركز	Focus
أعماله	Its
عزيز	Aziz
للسياحة	Travel
استاد	Stadium
اللواء	Brigade
يطلق	Called
وحسب	And
الوفود	Delegations
مبنى	Building
الظن	Conjecture
زايد	Zayed
للشئون	Affairs
التمثيل	Representation
الدراما	Drama
النجم	Star
القاسمي	Qasimi
اجتماعها	Its
مستواه	Level
وفيه	And
السريع	Fast
ونقل	And
المزارعين	Farmers
المسلمين	Muslims
الوضوء	Ablution
المعتقلين	Detainees
لغير	To
الدنيا	Minimum
الجامعي	University
توفي	Died
احتمال	Potential
بالتالي	Thus
عني	Me
التشيكي	Czech
وسالم	And
امم	United
اندونيسيا	Indonesia
المبذولة	Made
القنوات	Channel
سيارات	Car
رئيسة	Head
الطرف	Party
تنفذ	Implemented
قبيل	Such
المنتخبين	Elected
رأسه	Head
المعارضة	Opposition
المفهوم	Concept
بهما	Their
خطيرة	Serious
عدا	Except
التلوث	Pollution
الشرعي	Forensic
بسهولة	Easily
العراق	Iraq
الطالبات	Students
التقارير	Reports
أسرة	Family
التعددية	Pluralism
اللحظة	Moment
ساهمت	Contributed
نسب	Ratios
الدولار	Dollar
لمتابعة	To
حياتنا	Our
قاموا	Have
سياسات	Policies
روما	Rome
والقانون	Law
يحرم	Denied
تربوية	Educational
اميركي	US
المطروحة	Raised
الخطأ	Error
النسبة	Percentage
الوثائق	Documents
الانساني	Humanitarian
الاحصائية	Statistical
الرسم	Drawing
يحسن	Improves
رمي	Throw
سرعة	Speed
أهله	His
المبلغ	Amount
بعث	Sent
فوزا	Win
الثلث	Third
الموصي	Testator
الاستاذ	Professor
أولياء	Parents
وستكون	And
السفن	Ships
للقيام	To
الرحلة	Flight
المصرفية	Banking
التوبة	Repentance
معجم	Glossary
ويضم	Includes
أرى	See
والا	And
دينار	JD
بلدان	
للفروسية	Equestrian
الموازنة	Budget
لدي	I
لدوري	League
والمغرب	Morocco
مخاطر	Risk
بدورها	Turn
وحقق	And
المبادرة	Initiative
تعالى	Almighty
أغسطس	August
فريقا	Team
بدءا	Starting
احترام	Respect
مواطن	Citizen
وتقوم	The
لخدمات	Services
رياضية	Sports
عالميا	Globally
ولابد	To
علميا	Scientifically
بالقرآن	Koran
حفظه	Save
المعاصر	Contemporary
طريقها	Way
والخاص	The
فئات	GROUPS
فعندما	When
البريمي	Buraimi
تلبية	Meet
واشارت	She
الحرف	Crafts
اجتماعا	Meeting
الإرهاب	Terrorism
الحواجز	Barriers
ترفع	Raise
السعدي	Saadi
وتضم	Includes
ورجال	Men
وضرورة	And
الخطوط	Lines
الاهمية	Important
الهندية	Indian
الفطر	Mushrooms
تعرضت	Was
الهاتف	Phone
الإمارات	Emirates
واقامة	And
المراد	To
تحاول	Trying
الكذب	Lying
والكويت	Kuwait
وطالب	And
اللغوية	Linguistic
والتنمية	And
للغاز	Gas
الاستخبارات	Intelligence
المهاجم	Striker
الرحم	Uterus
الفقهاء	Jurists
الاستمرار	Hold
مشاركته	Participation
العقول	Minds
التخلص	Disposal
مسندم	Musandam
العكس	Contrary
تزايد	Increased
المهن	Professions
الإدارية	Administrative
ايطاليا	Italy
الأسئلة	Questions
بعرض	Width
يطلب	Asked
رضا	Reza
مهاجم	FW
القوم	Folk
تعمين	Omanisation
القضائي	Judicial
الضفة	West
ياسر	Yasser
مباشر	Direct
صادرات	Exports
سريعة	Links
جهات	Views
أمن	Security
تعكس	Reflect
اليمني	Yemeni
ذكرها	Mentioned
رائع	Gorgeous
وحاول	And
وزن	Weight
للتعاون	Cooperation
البيضاء	White
والتنسيق	And
الأسلوب	Method
اشتمل	Included
الشمال	North
يثبت	Proves
هدية	Gift
عملت	Worked
الحكومات	Governments
والعراق	Iraq
سابقة	Previous
شهرا	Months
علاوة	Moreover
تنظم	Organizes
ايها	O
الجمال	Beauty
ليصل	To
خاصا	Special
خطوط	Lines
الاوضاع	Conditions
للمهرجان	Festival
إجراء	A
السليمي	Sulaimi
أمه	His
بالقاهرة	Cairo
وتستمر	And
يساهم	Contributes
هذين	These
المشاعر	Feelings
عمانية	Omani
بنجاح	Successfully
يواصل	Continue
القبلة	Qibla
فأنا	I
الطويلة	Long
بالنفس	Self
شيخ	Sheikh
الفقر	Poverty
الامير	Prince
التحقيقات	Investigations
رياضة	Sports
الرد	Reply
وارتفع	Rose
لمشروع	Project
التطبيق	Application
يظل	Remains
ف	P
البالغة	Amounting
المناشط	Educational
الجابري	Jabri
اغلب	Most
خصائص	Properties
التوحيد	Unification
عذاب	Torment
والصحة	Health
قاعة	Hall
استقبل	Received
نظمت	Organized
الإشارة	Reference
جعلت	Made
افتتح	Opened
ومعرفة	And
مجيس	مجيس
وجهات	Views
وجميع	And
بنزوى	Nizwa
الهندسة	Engineering
الصغير	Little
الشقيقة	Sister
حصول	Get
يزور	Visit
التقييم	Rating
وبخاصة	Especially
مونديال	World
لوضع	To
أمرا	Is
الرسوم	Fees
بأنهم	They
يوفر	Provides
لاعبو	Players
الملائكة	Angels
الحضارية	Civilizational
عرضية	Occasional
ينتظر	Awaits
الخبير	Expert
تدل	Indicate
الحرص	Care
البدنية	Physical
قوانين	Rules
بأسلوب	Style
الدليل	Guide
دفاع	Defense
لكافة	For
يصلي	Pray
اتباع	Follow
الكاملة	Full
لأول	For
والحياة	Life
الاغلاق	Closing
تكلفة	Cost
كيلو	Kilo
ورحمة	And
تهم	Charges
النقطة	Point
بمعدل	At
فيمن	Those
تأسيس	Establishment
إليه	To
لدعم	To
حتي	Up
الفقراء	Poor
نيجيريا	Nigeria
نخبة	Elite
زينب	Zainab
برأسه	Head
يقتصر	Limited
الحادث	Incident
ضربة	Blow
التبادل	Exchange
نقوم	We
مؤمن	Believer
والطالبات	Male
ويعد	The
للدول	States
بالشكر	Thank
الصندوق	Fund
تسبب	Causing
مطالب	Demands
مسجد	Mosque
وعد	Promised
واعتبر	And
إسلامية	Islamic
المرتبة	Ranked
اسلوب	Style
توقيع	Signed
يعقد	Hold
التداولات	Trades
الحقل	Field
أمره	His
تعطي	Give
جذب	Attract
المحلات	Shops
باعتبارها	As
المعدة	Stomach
يحتل	Occupies
مجددا	Again
أبواب	Doors
شمس	Sun
الكهربائية	Electrical
اجمالى	Total
نعرف	Know
تأهل	Qualified
لتحديد	To
تبحث	're
القبض	Arrest
زيت	Oil
الدمار	Mass
للاطفال	Kids
تحليل	Analysis
ذو	With
التطوعي	Volunteering
الخلاف	Disagreement
الشر	Evil
حقائق	Facts
يسير	Walking
العناية	Care
ساحة	Square
الصيفي	Summer
معالم	Landmarks
أقرب	The
درجات	Scores
السحب	Cloud
التفسير	Interpretation
للكتاب	Book
تتطلب	Require
أفلام	Films
النحل	Bees
التقينا	We
الأحكام	Provisions
لتصل	To
الداعية	Calling
وتنظيم	The
الاعلان	Advertising
ربهم	Lord
الخطر	Risk
العدالة	Justice
المشارك	Co
تجري	Conducted
معنا	Us
الموظفين	Staff
أهمها	The
يصلح	Fit
الحي	District
للشركة	Company
دائم	Lasting
المزارع	Farms
يقومون	Carrying
حققه	Achieved
الاشخاص	People
الورثة	Heirs
الروايات	Novels
لتنمية	Development
استمرت	Lasted
ويوسف	Youssef
المعتمد	Approved
تأكيد	Confirm
إنتاج	Production
الهندسية	Engineering
اللغات	Languages
المتبعة	Followed
الأسواق	Markets
المعاهد	Institutes
الثانى	Second
خبير	Expert
رصف	Paving
النواحي	Respects
خبراء	Experts
يتناسب	Commensurate
للمشروع	Project
تكمن	Lies
أحدكم	One
تنظمها	Organized
فمثلا	Example
الراحل	Late
المختصين	Specialists
المباشرة	Direct
الالمانية	German
سفير	Ambassador
وعبد	And
اعتمد	Adopted
السيدة	Ms
جيش	Army
يستطع	Unable
ابتداء	Starting
الأندية	Clubs
ثابت	Fixed
والشركات	The
الأوروبي	European
العظام	Bone
الأوروبية	European
سلاح	Force
الصحفيين	Journalists
رسميا	Officially
المعروفة	Known
الاشهر	Months
المتميز	Excellence
لوحات	Plates
بطلا	Hero
المشركين	Idolaters
بالشكل	As
الشكر	Thanksgiving
التمويل	Finance
بدولة	State
كيلومترا	Km
عاصمة	Capital
الترجمة	Translation
مرباط	Mirbat
بعيدة	Far
تحدد	Set
المناهج	Curriculum
الصفات	Attributes
فقرات	Paragraphs
نفسه	Same
مجموع	Total
والمركز	And
وتلك	And
المفاهيم	Concepts
للاستفادة	To
الروسي	Russian
وطنية	The
التنافس	Competition
بالتنسيق	Coordination
حرف	Character
بجميع	All
استقرار	Stability
باعتباره	As
يفكر	Think
المنتج	Product
اسبانيا	Spain
المعركة	Battle
نجاحا	Successful
تفوق	Than
مبينا	Indicating
جودة	Quality
طلال	Talal
الاولية	Initial
علمي	Scientific
استخدامها	Use
الداخل	Inside
قبول	Accept
للمسلمين	Muslims
الهجري	AH
دارفور	Darfur
ووسائل	And
وردت	Received
البرتغالي	Portuguese
بتوفير	Providing
الايرانية	Iran
والمعرفة	And
إجمالي	Total
حدة	Unit
صفحة	Page
ودراسة	The
الفراغ	Vacuum
تجديد	Renewal
النووي	Nuclear
الربع	Quarter
مجلة	Magazine
اعتبر	Considered
الفرس	Persians
المقررة	Prescribed
للعراق	Iraq's
والدكتور	Dr
أتى	Came
القضائية	Judicial
عماد	Imad
نماذج	Models
الحسني	Hassani
الاسرائيلية	Israeli
تسهم	Contribute
الاشراف	Supervision
بكثير	Much
الابتدائية	Trial
طبيعية	Normal
الحمل	Pregnancy
الحظ	Fortune
رابعا	IV
وأخيرا	Finally
القدرات	Capacity
التحول	Shift
شئون	Affairs
وتنفيذ	The
آخرين	Others
القوي	Strong
دم	Blood
فالله	God
العقود	Contracts
المحيط	Ocean
دخلت	Entered
الرحمة	Mercy
مالا	Mala
اختتمت	Concluded
النواب	Representatives
أقيمت	Held
واعضاء	And
التوقيع	Signature
السن	Age
أنحاء	Around
تقدر	Estimated
الاختيار	Choose
التكريم	Honoring
يكاد	Almost
تقارير	Reports
زادت	Increased
تتناول	Address
الإسلام	Islam
المؤمنون	Believers
تفاصيل	Details
تقبل	Accept
البرلمان	Parliament
الروسية	Russian
النظرة	Outlook
علوم	Science
وجوه	Faces
الصدد	Connection
القابضة	Holding
وغيره	The
سماحة	Samaha
مقومات	Constituents
العربية	English
وبشكل	And
ظلت	Remained
الماضي	Past
أنك	You
صنعاء	Sanaa
الاسئلة	Questions
كافية	Sufficient
عنه	About
الانجازات	Achievements
اخذ	Taking
بتنظيم	Organized
الأصول	Assets
التشريع	Legislation
يقارب	Nearly
الاشياء	Stuff
أسماء	Names
وعشرين	Twenty
النهوض	Advancement
ماجد	Majid
ودعم	And
الضعف	Weakness
وتحسين	And
لقاءات	Encounters
المعايير	Standards
فلو	Flo
عددهم	Number
الحاكم	Ruling
التابع	Of
المخاطر	Risk
والدولية	The
فرع	Branch
الخروصي	Kharusi
الأعلى	Top
المغربية	Moroccan
وصدق	And
مستمر	Continuous
المهرجانات	Festivals
المكتبة	Library
اليابانية	Japanese
استطاعت	Managed
الهام	Important
تدعو	Calling
ويوم	Day
الذاتية	Self
وكاد	And
جلسات	Sessions
المستمرة	Continuous
محاولات	Attempts
القادر	Qadir
اليتيم	Orphan
الموسيقية	Music
منها	Including
إله	God
الحجر	Stone
جولة	Round
لأجل	For
الحكومي	Government
تميز	Excellence
الفريقان	Teams
ومديري	And
كريم	Karim
عاش	Lived
لقوله	For
اليونانية	Greek
والاجتماعي	The
ولذا	So
الصعيد	At
يتحقق	Achieved
دي	De
للاوراق	Securities
الفائزة	Winning
وثيقة	Document
الخطوات	Steps
دينية	Religious
الاهالي	Residents
عرضا	Offer
حبيب	Habib
يصدر	Issued
رئيسية	Key
وليد	Walid
قائلة	Saying
يتعرض	Exposed
بواقع	By
التقى	Met
هود	Hood
البيوت	Houses
الواضح	Clear
الطبيب	Physician
الخمس	Five
انحاء	Around
تشغيل	Run
الاموال	Money
بمدينة	In
عليها	By
نريد	Want
عشرين	Twentieth
الجنسية	Nationality
الوطنى	National
الحلم	Dream
مشروعات	Projects
سهما	Shares
أنزل	Down
الرواس	Rawas
فانها	It
اعلنت	Announced
أقول	Say
الغاية	End
بات	Pat
صحيحة	True
فلابد	Must
رسم	Drawing
النبوي	Prophetic
اذن	Permission
بكلمة	Word
القريب	Near
التوصل	Reach
مكانة	Position
التحالف	Alliance
فقلت	I
واخيرا	Finally
التونسي	Tunisian
تمام	Tammam
المرتبطة	Associated
القدس	Jerusalem
أريد	I
لوزارة	Department
وكذا	As
الأداء	Performance
سيدني	Sydney
الجمهورية	Republic
النظرية	Theory
انطلاقا	From
لبناء	To
طالبا	Students
المصلحة	Interest
بسرعة	Fast
ويقوم	The
عددها	Number
عميد	Dean
الخطوة	Step
والتعرف	And
الخمسة	Five
الصوت	Audio
الغربي	West
يدفع	Pays
النقدية	Cash
السرعة	Speed
بهدفين	Two
واليابان	And
نفوسهم	Them
بنات	Girls
صياغة	Formulation
يتجاوز	Exceeds
وجمع	The
الصعب	Difficult
الأرض	Earth
جو	Joe
المنزل	House
الحضارات	Civilizations
بكافة	All
اسلحة	Weapons
الإنساني	Humanitarian
بزيادة	An
رسمية	Official
لبطولة	Championship
حلقات	Rings
أضاف	Added
علاج	Treat
القليلة	Few
وأحمد	And
الجنين	Fetus
الاسلامى	Islamic
عكس	Reverse
للقطاع	Sector
الاستعداد	Standby
النجوم	Stars
طاقة	Energy
مثلما	As
التخصصات	Disciplines
انفسهم	Themselves
واختتم	And
العسكري	Military
القائد	Commander
البقاء	Stay
الابيض	White
هاما	Important
الحرس	Guard
طريقه	Way
مباراته	Game
والولايات	And
فرانس	France
وتقدم	The
بعضا	Some
بالتعادل	Draw
إيجاد	Find
الخالق	Creator
القصيرة	Short
المنشآت	Installations
موضع	Position
الذهبي	Golden
ألم	Pain
تناولت	Dealt
أسس	Founded
هدى	Huda
شرف	Honor
طويلا	Long
99م	
والمسلمين	And
خلاف	Otherwise
مواقف	Positions
فضيلة	Eminence
وشارك	Participated
حضارة	Civilization
الكشف	Detected
بسيطة	Simple
انطلاقة	Breakthrough
تجارية	Commercial
تجاوز	Exceeded
حاتم	Hatem
زاهر	Zaher
للمجلس	Council
المواجهة	Confrontation
يؤمن	Believes
عملها	Work
الافريقية	African
رصيد	Balance
بوشر	Bucher
قررت	Decided
انشطة	Activities
رؤساء	Heads
التجارى	Commercial
الوحيدة	Only
صندوق	Fund
المنفذة	Executed
التدريس	Teaching
كفاءة	Efficiency
المعارف	Knowledge
توسيع	Expand
الارتقاء	Upgrading
الاسباب	Reasons
عظيمة	Great
الميدانية	Field
السهم	Stock
هاشم	Hashim
والمتوسطة	And
يحل	Solves
عمران	Imran
الايطالي	Italian
الايراني	Iranian
بدل	Instead
المواهب	Talent
صنع	Making
المفاوضات	Negotiations
وايجاد	And
المهنة	Occupation
وسيكون	And
ثابتة	Fixed
فائدة	Interest
الواردة	Contained
أحدا	One
اتجاه	Direction
لاقامة	To
المؤشرات	Indicators
ميدالية	Medal
الأهلي	Ahli
واجب	Duty
لاعبيه	Players
المذاهب	Doctrines
الهادفة	Aimed
التشريعات	Legislation
منك	You
ملتقى	Forum
استقبال	Receive
للخدمات	Services
الأراضي	Land
المؤكد	Certainly
سبل	Ways
الشبابي	Youth
مسؤولية	Responsibility
استعراض	Review
فهد	Fahd
المنازل	Houses
الإباضية	Ibadi
ركنية	Corner
للصحفيين	Told
الامتحانات	Exams
تصوير	Photography
ربنا	Lord
كشف	Revealed
تعادل	Equivalent
الأكبر	Largest
نفسية	Psychological
والمناطق	And
لمكافحة	Against
فرد	Individual
وبهذا	In
التغذية	Nutrition
التوصيات	Recommendations
والحضور	And
الحكمة	Wisdom
سببا	Cause
خطر	Risk
قادر	Capable
تقدمه	Offer
واستطاع	And
برعاية	Sponsored
اللاعبون	Players
البطاقة	Card
اطلاق	Launch
يتناول	Addresses
والاستثمار	And
المستشفى	Hospital
الظلم	Injustice
طالما	As
نجم	Star
قطاعات	Sections
بعمل	Work
الشروط	Conditions
للكرة	The
عموما	Generally
اولمبياد	Olympics
صلاح	Salah
السينمائية	Cinematic
الأمراض	Diseases
قلة	Few
مريم	Mary
السياح	Tourists
مسئول	Official
كونها	Being
جميل	Beautiful
اراد	Arad
لضمان	To
والوفد	The
بيننا	Us
ودعا	And
كذا	As
تصبح	Become
الجيل	Generation
بمبلغ	At
السكنية	Residential
يعبر	Crosses
ومتابعة	And
بركاء	Barka
المستخدمة	Used
انطلقت	Off
بالعديد	Many
تدور	Revolve
نصوص	Texts
الاسماك	Fish
فني	Art
تداولات	Trades
والاهتمام	And
قدرات	Capacity
العجز	Deficit
ثالث	Third
تاريخية	Historic
العبادة	Worship
نجوم	Stars
الكأس	Cup
التأثير	Influence
تعني	Means
وشركات	The
اعلى	Top
التنفيذ	Implementation
لاسيما	Especially
لتوفير	To
تنطلق	Off
غالبا	Often
المسال	LNG
الحماية	Protection
المبادئ	Principles
الذاتي	Self
الآباء	Parents
النووية	Nuclear
والدراسات	Studies
يحاول	Tries
أوضح	Explained
التنظيم	Regulation
العطاء	Tender
الحيوية	Vital
الاخضر	Green
بالوزارة	Ministry
العيش	Live
تعديل	Amendment
السيابي	Siyabi
ومدرسة	School
بحر	Sea
مئات	Hundreds
مضى	Before
الحمراء	Red
الاعلامية	Media
يسمح	Allows
مسافة	Distance
تبدو	Look
الاحداث	Events
حرج	Critical
نعمة	Grace
لانشطة	Activities
وبدأ	And
يريدون	Want
اللبنانية	Lebanese
أسلوب	Style
هنالك	There
التراثية	Heritage
تعيش	Live
البعد	Dimension
أى	Any
المسئولية	Responsibility
برس	Press
ويؤكد	Confirms
يشمل	Includes
فريضة	Obligatory
بالرغم	Although
الاسلحة	Weapons
البدء	Begin
آلية	Mechanism
أمور	Things
الخوف	Fear
الصلة	Link
خارجية	External
يقدمها	Provided
مكتبة	Library
خبرة	Experience
تملك	Owns
أصحابه	His
وتكون	And
قرر	Decided
ربي	Lord
الام	Mother
الدار	Aldar
المادي	Physical
أية	Any
تؤثر	Affecting
يكفي	Enough
مقتل	Killing
شديدة	Severe
بتنفيذ	Implementation
بالقرب	Near
للثقافة	Culture
كبرى	Major
يخص	For
كثرة	Frequent
مانع	Blocker
يمثلون	Representing
ر9	
ست	Six
يذهب	Go
اصدار	Issue
الفرح	Joy
وقدره	And
الاربعة	Four
الأمانة	Secretariat
وقيل	It
الرسمي	Official
درويش	Darwish
منه	From
نفوس	The
إليك	Here
شملت	Included
الغذاء	Food
ابطال	Champions
النامية	Developing
النبوية	Prophetic
جعلان	Jalan
الأخلاق	Ethics
المواقف	Positions
باستمرار	Down
للفريق	Team
حياتهم	Lives
النصف	Half
مستقبلا	Future
الخليلي	Khalili
الاردنية	Jordan
الأجهزة	Devices
اهتماما	Interest
تساهم	Contribute
بقي	Remained
والمرأة	The
لزيادة	To
اندية	Club
المكرمة	Mecca
المحاضرة	Lecture
الطيب	Tayeb
هجوم	Attack
لفترة	For
سمعت	Heard
الانتخابية	Electoral
باكستان	Pakistan
الملكية	Royal
الصحيفة	Paper
السليم	Proper
المقابلة	Interview
نساء	Women
العدو	Enemy
الصحفي	Press
عمره	Old
يدرك	Realizes
الحسنة	Good
سجلت	Recorded
التنفيذية	Executive
الشاب	Young
المساعدة	Help
الفارق	Difference
الاطار	Frame
الصيني	Chinese
يومي	On
الهندي	Indian
ميدان	Field
تخصيص	Allocation
بعده	After
السنوية	Annual
نفط	Oil
صفات	Recipes
البرتغال	Portugal
الرحبي	Rahbi
اللوحة	Plate
الفجر	Dawn
الفائز	Winning
التأمين	Insurance
العامري	Ameri
وفاز	And
عسكرية	Military
يلتقي	Meet
اوراق	Securities
للنفط	Oil
اللبناني	Lebanese
الوسطى	Central
تتحدث	Talk
شئ	Something
التوازن	Balance
فيها	Where
منتخبات	Teams
قصيرة	Short
تصور	Imagine
حمدان	Hamdan
بذل	Make
العاشر	X
المركزية	Central
تلعب	Play
العصور	Ages
أصول	Assets
قدمه	By
المحاكم	Courts
وذكرت	The
نوعا	Somewhat
الاوراق	Securities
اعتقد	I
التاسعة	Ninth
الدولى	International
دوره	Role
الرغبة	Desire
مراقبة	Control
اقيم	Held
الميت	Dead
بنحو	About
وبرامج	And
الإبداع	Creativity
صفة	Recipe
فيصل	Faisal
الحجاج	Pilgrims
أشد	Most
السليمة	Sound
اعتبارا	As
جلالته	Majesty
ويشارك	And
التأكيد	Verification
نقص	Lack
الزوار	Visitors
الرشيدة	Good
المهنية	Professional
ومركز	And
حقه	Right
المريض	Patient
وصية	Commandment
بقاعة	Hall
القومية	National
لمسافة	For
اللون	Color
محسن	Mohsen
السلبية	Negative
للبرميل	Barrel
السيارة	Car
وقام	The
الصالحة	Potable
المدى	Range
الذات	Self
خسر	Lost
والبحث	Search
الأعضاء	Members
يعقوب	Jacob
ربيع	Spring
أحداث	Events
عمرو	Amr
دينه	Dinh
الهولندي	Dutch
الامراض	Disease
يساعد	Help
الآثار	Effects
المشرف	Supervisor
لاعبا	Player
قادرة	Able
نيويورك	New
والحمد	Praise
الصادر	Issued
ثمة	There
أجهزة	Devices
المشهد	Scene
يقبل	Accept
مات	Died
بلاد	Country
يمنع	Prevents
حوادث	Accidents
تصفيات	Qualifying
الصناعي	Industrial
الجهل	Ignorance
خروج	Exit
الاصابة	Injury
محاور	Axes
الرقابة	Control
يدي	Lady
للفوز	To
غد	Tomorrow
بحثا	Search
الضرورية	Necessary
وصول	The
طويل	Long
اعتماد	Adoption
ومناطق	And
جراء	By
والمالية	The
لولا	Lula
الطويل	Long
التغيير	Change
معاني	Meanings
زمان	Zaman
تأليف	Authored
الانتاجية	Productivity
الثامنة	Eighth
وبلغت	And
الوظائف	
الفنانة	Artist
الاهلية	
اهل	Folks
كلمات	
إما	Either
المسائل	Matters
لمنتخبنا	For
حدوث	A
يده	His
مبلغ	The
استعدادا	Preparation
عامل	Factor
منافسة	Competition
الزيتون	Olive
سمائل	Sumail
وأيضا	And
يواجه	Faces
التقنيات	Technologies
بمقر	At
اليمنية	Yemeni
للطفل	The
الزيارات	Hits
شعبان	Shaaban
الامانة	Amana
للقرآن	Of
اهمها	The
مسئولية	Liability
الصيفية	Summer
بلال	Bilal
الفلوجة	Fallujah
سهلة	Easy
اللذين	Two
وقوع	The
توقف	Stop
أحيانا	Sometimes
قلوب	Hearts
الصعوبات	Difficulties
البحري	Marine
موجودة	Existing
مساهمة	Contribution
غيرهم	Others
الاطلاع	See
والذى	Which
فيه	Where
بفوز	Win
الهجرة	Immigration
المؤرج	Almarj
تخدم	Serve
اكتشاف	Discover
ملك	King
الطالبة	Requesting
الاولمبياد	Olympic
الحكام	Rulers
تعاني	Suffer
الطرفين	Parties
العامل	Group
الطيور	Bird
يخدم	Serves
يعتقد	Believed
لحماية	To
بيته	His
العموم	Commons
الكندي	Canadian
يقدر	Estimated
الورقة	Paper
وسعيد	Said
يديه	His
لأحد	For
يعملون	Employed
العقيدة	Creed
الاعلى	Top
الاقتصادى	Economic
يونس	Younis
السلوك	Behavior
شاملة	Comprehensive
الممكن	Possible
ولد	Born
له	His
تدريبية	Training
للبطولة	Championship
رحب	Welcomed
عباده	Slaves
عبدالرحمن	Abdulrahman
مقدمة	Introduction
اللقاءات	Encounters
التنموية	Development
يضع	Puts
قليلة	Few
تقف	Stand
وبالنسبة	For
لاول	For
الاجتماعات	Meetings
القصيدة	Poem
للغاية	Extremely
البعثة	Mission
مازال	Still
واغلق	And
دولارا	US
قوي	Strong
الراشدي	Rashidi
واضحا	Clear
اسواق	Markets
مساعدة	Help
القاضي	Judge
الجنوب	South
تعليم	Education
لأي	Any
الممثل	Representative
وحل	Resolution
نكون	Be
الحاج	Haj
الكوادر	Cadres
وخالد	Khaled
تصدر	Issued
القائمين	Existing
يقرأ	Reads
تستخدم	Used
المجاورة	Neighboring
مستمرة	Continuous
الرياض	Riyadh
الأوسط	East
سياحية	Tourist
عادل	Just
قريب	Close
اولى	First
بيئة	Environment
الباب	Section
النفوس	Souls
تعبر	Reflect
مظاهر	Manifestations
الزيادة	Increase
وقدم	The
يرد	Is
عقود	Contracts
بنا	Us
الصف	Grade
محطات	Stations
الاسباني	Spanish
أمين	Secretary
لفريق	Team
معالى	HE
سقوط	Fall
لمعرفة	To
الواقعة	Located
الاعتبار	Account
تأهيل	Rehabilitation
سائر	Other
حوار	Dialogue
الكبار	Adults
جلالة	Majesty
الاداري	Administrative
والفعاليات	And
الاعداد	Numbers
مستشفى	Hospital
صفقة	Deal
تتمتع	Enjoys
شرع	Embarked
بجانب	Next
والمشاركة	And
أوبك	OPEC
للاتحاد	Union
العاب	Games
الثمانية	Eight
مشرف	Musharraf
جمهورية	Republic
شؤون	Affairs
رأيت	I
الكليات	
الهوكي	Hockey
قولكم	Your
فكر	Think
طارق	Tariq
ذا	The
الفردية	Individual
والغاز	And
اليوناني	Greek
الابداع	Creativity
يمر	Passes
ربط	Linking
كون	The
الجائزة	Award
الآسيوية	Asian
الوكالة	Agency
الشكل	Figure
تحويل	Convert
مهارات	Skills
السبيل	Way
وتعزيز	And
ثبت	Proven
يستمر	Lasts
تعاون	Cooperation
يتمتع	Enjoys
المقامة	Built
المضيبي	Hush
الدقائق	
الفلسطينيين	Palestinians
وماذا	And
بكلية	Faculty
ساهم	Contributed
الوجه	Face
الجودة	Quality
ميناء	Port
حينما	When
الحجة	Argument
وليست	Not
اسباب	Reasons
999	
القرى	Villages
مرتين	Twice
الحياة	Life
قريات	Quriyat
والمعلومات	The
بلد	Country
مراعاة	Taking
الاهلي	Ahli
باللغة	In
شديد	Severe
عمانى	Omani
صحفي	Press
واليوم	Today
المسلسل	Serial
اتفاق	Agreement
نزل	Down
تبين	Show
الصحافة	Press
عشرات	Scores
يشير	Indicates
بك	Your
أبرز	Most
المنظمات	Organizations
النخيل	Palm
للطاقة	Energy
كنتم	You
وخلال	During
الصباح	Morning
بطول	A
بمجمع	Complex
ومحاولة	And
وكم	How
والثانية	The
يرعى	Sponsored
يقام	Held
الجبل	Mountain
المرور	Traffic
الرواحي	Rawahi
امكانية	The
بتلك	Those
المتحدث	Speaker
السعي	Seeking
الواحدة	Per
الفتاة	Girls
السينمائي	Film
مواصلة	Further
جهد	Effort
الاكبر	The
مهم	Important
يعاني	Suffers
حديثة	Modern
لمنطقة	For
حديثا	Newly
صحية	Healthy
تطرق	Touched
فعلى	For
تركيا	Turkey
الشبكة	Network
ودور	And
بنظام	System
الحملة	Campaign
قدمها	By
الكويتية	Kuwaiti
لوحة	Panel
للصناعات	Industries
حوله	Around
الطليعة	Vanguard
شراء	Buy
والفنية	And
بضرورة	Need
سيد	Mr
الفساد	Corruption
يشاء	Wills
الموسيقى	Music
ماله	His
الخليل	Hebron
وحين	When
وإلا	And
القرم	Crimea
الفائزين	Winners
تتضمن	Includes
ثقة	Confidence
المستثمرين	Investors
وطرق	And
الافضل	Best
ترجمة	Translation
ينقل	Transferred
إليهم	Them
السلة	Basketball
الحضاري	Civilizational
السفير	Ambassador
المستهلك	Consumer
يدور	Spins
اسماعيل	Ismail
أمير	Amir
وتشجيع	And
عبيد	Obeid
النبهاني	Nabhani
الجسد	Body
تصريحات	Remarks
أستاذ	Professor
للدولة	State
المصنعة	Processed
لجان	Committees
واصحاب	The
دراسات	Studies
عروض	Offers
الجانبين	Sides
وظيفة	Function
الناس	
الاقل	Least
السودان	Sudan
الخريف	Autumn
غانم	Ghanem
ايجابية	Positive
باستخدام	Using
أعلن	Announced
الارتفاع	Elevation
يعطي	Gives
يؤثر	Affects
علاقات	Relations
لتلك	Of
إذن	Permission
السير	Sir
وعمل	And
نيابة	On
عنهما	Them
خريف	Fall
قطعة	Piece
عوض	Awad
الفكري	Intellectual
أثينا	Athens
الاماراتي	Emirati
المنكر	Evil
تداول	Trading
سيدنا	Master
شرح	Explain
اني	I
وسيتم	Will
الاتجاه	Direction
فوائد	Benefits
الزدجالي	Zadjali
يختلف	Differs
الريامي	Riyami
الدوائر	Circuit
جبل	Mount
الاولمبي	Olympic
لصاحبها	Its
فعلا	Actually
واضافت	And
يفعل	Do
العربى	Arab
منع	Prevent
الصادرة	Issued
الشعوب	Peoples
خسارة	Loss
والاتصالات	And
دورها	Its
يعرض	Displays
صاحبه	Owner
الأشياء	Things
9ر	
يترك	Leaves
المباشر	Direct
كونه	Being
الحقائق	Facts
محددة	Specific
الالكترونية	E
المسؤول	Official
بحسب	According
روى	Roy
تضمن	Included
دولية	International
البر	Barr
يلي	Following
إنا	Verily
الاستثمارية	Investment
المرورية	Traffic
المتعددة	Multiple
أعظم	Greatest
الشباك	Nets
الانكليزية	English
آثار	Effects
نسبته	Per
نظم	Systems
حمزة	Hamza
معسكر	Camp
البصر	Sight
انتهى	Over
لعدد	Number
بشير	Bashir
تجارب	Test
الاسرائيلي	Israeli
الدائم	Permanent
قطع	Cut
تذكر	Remember
وتأتي	The
مصلحة	Interest
أربع	Four
وانا	I
الاعتماد	Dependence
الخارجي	External
كتابة	Writing
الرقم	Number
احتياجات	Needs
صعبة	Difficult
بريطانيا	Britain
بنفسه	Himself
بتوزيع	Distribute
اميركا	America
الأدب	Literature
صدق	Believe
المهني	Professional
تؤكد	Confirms
تقل	Less
الاستقرار	Stability
بعدم	Not
حامل	Holder
الحزب	Party
الأفلام	Movies
البحار	Seas
العقد	Contract
مسابقات	Contests
شأنه	Would
الوقوف	Stand
الأموال	Money
النهائيات	Finals
الهواء	Air
بفندق	Hotels
جلسة	Session
ولي	Crown
المسألة	Issue
9م	
حقيقية	Real
الحاسوب	Computer
قصر	Palace
المهم	Important
المدني	Civil
التكنولوجيا	Technology
بمسقط	Muscat
تواصل	Continue
الامنية	Security
ساعات	Hours
رغبة	Desire
المختصة	Competent
مرت	Passed
الجنود	Soldiers
يجمع	Combines
انتهت	Over
فشل	Failure
سيارة	Car
وبناء	And
تمر	Pass
وضعت	Placed
زال	Still
جيل	Generation
الشئون	Affairs
غزة	Strip
سياسية	Political
بعثة	Mission
اجتماعات	Meetings
ليغلق	To
صرح	Said
اساس	Based
ومنذ	Since
العهد	Testament
مهنة	Career
رحمة	Mercy
المالي	Financial
ممارسة	Exercise
وأنت	And
الوحي	Revelation
وكالات	Agencies
الاراضي	Lands
للعام	For
الحيوانات	Animals
يقل	Least
ترتيب	Order
يتوقع	Expected
أنني	I
منكم	You
الاشارة	Reference
فئة	Class
طلبة	Students
نشاط	Activity
بالسوق	Market
تحرير	Liberation
وتبادل	And
وخصوصا	Especially
ضمان	Ensure
توجيه	Directing
ثمانية	Eight
الاستراتيجية	Strategy
المساهمة	Contribute
الأحداث	Events
مجموعات	Groups
ومشروع	And
انني	I
خطورة	Seriousness
اللعبة	Game
الشامل	Comprehensive
يبحث	Looking
خرجت	Out
اليمنى	Right
البشري	Human
الخسارة	Loss
المحور	Axis
مساحة	Space
المتوسط	Average
التوجه	Orientation
اجهزة	Devices
الشؤون	Affairs
غرب	West
الجوية	Air
تقدير	Estimate
صلة	Link
نظرة	Look
شبه	Almost
انواع	Types
الصينية	Chinese
وتحديد	And
انتخابات	Elections
الحوادث	Accidents
الديني	Religious
باريس	Paris
التالية	Following
اوضح	Said
ووزارة	And
الديمقراطية	Democracy
تلقى	Received
تتميز	Featuring
البطولات	Tournaments
السمو	Highness
التحكيم	Arbitration
المركزي	Central
لعبة	Game
الشعبي	Popular
السكان	Population
اعتبار	Considered
بمستوى	Level
الليلة	Night
عبادة	Cult
ممثل	Representative
التطوير	D
القوية	Strong
الصيد	Fishing
الضغط	Pressure
أبدا	Never
مسلسل	Series
يتضمن	Includes
فإنها	It
السياسات	Policies
بعدد	Number
المشكلات	Problems
الحلول	Solutions
بوجود	The
الحوسني	Hosani
وهما	Two
بالمديرية	Directorate
زاد	Increased
روسيا	Russia
ومدى	And
لمواجهة	To
نستطيع	We
خطوات	Steps
ميلان	Milan
شعرية	Lattice
شعر	Hair
فكل	All
الانكليزي	English
بدوره	Turn
ادى	Led
المساجد	Mosques
شأنها	Will
ظروف	Conditions
تستمر	Continue
ثالثا	Thirdly
ماتشالا	Macala
ممكن	Possible
اجتماعية	Social
السامية	High
بصلالة	Salalah
مجتمع	Community
للمواطنين	Citizens
البرازيلي	Brazilian
وحصل	And
مضيفا	Adding
الحمد	Praise
المقام	Above
وجعل	And
طول	Length
المبارك	Blessed
عادة	Usually
أبناء	Sons
للاتصالات	Telecom
فقالت	Said
انطلاق	Starting
مستقبل	Future
مسؤول	Official
بكين	Beijing
أرض	Land
وجهة	Point
تعتمد	Depends
بمركز	Center
الذهاب	Go
المؤهلة	Eligible
بنفس	The
الياباني	Japanese
الشاملة	Overall
وتعتبر	The
الرؤية	Vision
بحق	Against
لتنفيذ	For
المتقدمة	Advanced
متميزة	Distinct
الندوات	Seminars
الجزيرة	Island
ولما	As
الإنتاج	Production
حوالى	About
زالت	Still
يكونوا	Be
المستويات	Levels
نظيره	Counterpart
الالتزام	Commitment
وعند	When
العودة	Back
شخصا	People
أفراد	Members
عملا	Pursuant
يرجع	Due
الأسباب	Causes
والتدريب	And
الانجاز	Achievement
حجة	Argument
مرور	Over
النهار	Day
حرية	Freedom
حققت	Achieved
تقييم	Rating
مجمع	Complex
سلامة	Safety
الكلمات	
وفيما	With
للمنتخب	Team
المغربي	Moroccan
أصل	Out
المحاضرات	Lectures
الصور	Photo
المعنى	Meaning
وجهه	Face
شهادة	Certificate
سبع	Seven
فكانت	Was
مشاكل	Problems
السوري	Syrian
لنفسه	For
صعوبات	Difficulties
مقر	Headquarters
الجبال	Mountains
العبري	Hebrew
إسرائيل	Israel
القصص	Stories
الأفكار	Ideas
لتقديم	To
السلامة	Safety
المباركة	Blessed
باقي	Other
الجيدة	Good
خليجي	Gulf
ابي	Abe
يقف	Stand
نوعية	Quality
المرض	Disease
تعلم	Learn
المقاومة	Resistance
معالجة	Processing
ويكون	And
عبدالعزيز	Abdulaziz
لخدمة	To
مدار	Over
صوت	Voted
ببوشر	ببوشر
رأي	Opinion
الاميركيين	US
وعبدالله	Abdullah
البنية	Structure
تريد	Want
لعدم	Not
الصدر	Chest
للحياة	Life
سلام	Peace
ظهرت	Appeared
عربي	English
لهما	Two
بعيد	Far
بمقدار	By
محكمة	Court
الامين	Secretary
قريبا	Soon
المشاركون	Participants
البقرة	Cow
التشكيلي	Studio
الاجهزة	Setups
العالية	High
مبدأ	Principle
يكتب	Writes
تكوين	Configuration
نهائي	Final
الحاضر	Present
تجعل	Makes
الوفاء	Meet
ومما	Than
الداخلي	Internal
الواجب	To
الفرقة	Band
موسم	Season
اليونان	Greece
حمل	Download
تفسير	Interpretation
بالعمل	Work
اختلاف	Difference
سابق	Former
العوامل	Factors
قويا	Strong
الحبسي	Habsi
الركن	Corner
خلقه	Created
الاحتياجات	Needs
هجمات	Attacks
تغطية	Cover
تشير	Indicate
للجميع	All
بيانات	Data
اوبك	OPEC
جميلة	Beautiful
التوعية	Awareness
سيما	Especially
عثمان	Osman
الاكثر	Most
المعاصرة	Contemporary
تغير	Change
الوسط	Center
الأساسي	Basic
عرفات	Arafat
السالمي	Salmi
تقدمها	Provided
مرض	Disease
متى	When
للحصول	For
الناتج	Output
زوجها	Her
دقائق	
الاف	Thousands
مزيد	More
تختلف	Vary
الحرة	Free
الذهبية	Gold
انخفاض	Low
معين	Given
العنف	Violence
وسلم	Him
دعا	Called
مواد	Materials
بشيء	Something
التوفيق	Reconcile
قريش	Quraish
تقنية	Technology
حرة	Free
تحول	Turning
إعداد	Preparation
الصراع	Conflict
المرء	One
المانيا	Germany
للوصول	To
إعادة	Re
العشرين	Twenty
للمرأة	Women's
زياد	Ziad
العبد	Slave
أحب	Like
يومين	Days
آدم	Adam
الأستاذ	Mr
منى	Mona
احداث	Events
تأخذ	Take
الفئة	Category
عودة	Back
تنفيذها	Implementation
الادعاء	Claim
كلام	
الاسكان	Housing
وحسن	Hassan
والعلوم	
اعلم	Know
التجارب	Experiments
التطورات	Developments
الخبراء	Experts
لانها	It
ألقى	Delivered
الاردن	Jordan
والاستفادة	And
القدر	Just
التحقيق	Investigated
حضور	Attend
حرم	Denied
الفارسي	Persian
أدى	Led
يتمكن	Able
الطيران	Flight
ارتفعت	Rose
وصف	Description
التقويم	Calendar
التجديد	Renewal
للإنسان	To
عليه	It
قوم	Folk
الخام	Crude
المثال	Example
العشر	Ten
الدوحة	Doha
لسان	San
ورسوله	And
فصل	Chapter
حميد	Hamid
انما	But
مترا	Meters
امين	Amin
الأخير	The
البيع	Sales
البالغ	Of
كلمته	His
وقعت	Signed
الالماني	German
الشخصيات	Figures
ابناء	Sons
الشهادة	Certificate
قلبه	His
وسعادة	HE
والبرامج	And
هى	Is
السيطرة	Control
الاندية	Clubs
غاية	Extremely
مطلع	Early
الأنشطة	Activities
المتميزة	Outstanding
الثانوية	Secondary
صحم	Saham
عوامل	Factors
كيري	Kerry
المتخصصة	Specialized
قدرها	Of
سن	Age
رحلة	Flight
جرى	Was
المدن	Cities
عالمية	Global
التواصل	Communication
تعرف	Know
التأهل	Qualifying
ثقافية	Cultural
ذكرت	Reported
عبيدة	Obeida
احراز	Score
الإدارة	Leaders
الطريقة	Way
المنتدى	Forum
رواية	Novel
تتمثل	The
القديم	Old
ثقافة	Culture
وبلغ	And
الكامل	Full
عيد	Holiday
الجو	Air
الجميلة	Beautiful
مسجلا	Registered
ت	T
والاقتصادية	And
الجيد	Good
يجري	Being
وقف	Stop
استمرار	Continued
السلع	Goods
الختام	Closing
و9	And
ومنهم	And
الآلي	Automated
بدور	Role
ستقام	Will
توجه	Draws
الانباء	News
مالك	Malik
يأخذ	Takes
فليس	No
ويرى	And
اجراءات	Measures
أميركا	America
أخي	Brother
لاعبين	Players
الصحف	Newspapers
المعهد	Institute
التحديات	Challenges
إني	I
دورات	Cycles
بمناسبة	On
رعى	Patronized
معهد	Institute
إنشاء	Create
كاملة	Full
الصيف	Summer
السؤال	Question
بفارق	A
ثاني	Second
قرب	Near
بينه	Between
منتصف	Mid
بيروت	Beirut
هامش	Margin
أخذ	Taking
ورئيس	Prime
شروط	Terms
البخاري	Bukhari
النفسي	Psychological
أولئك	Those
عاد	Returned
طلاب	Students
رجلا	Man
بنتيجة	Score
مني	Me
فريقه	His
نجح	Succeeded
المجمع	Composite
ماء	Water
تتم	Are
الحاسب	Computer
التليفزيون	TV
الانتهاء	Completed
القرارات	Resolutions
بالمعروف	Virtue
عامر	Amer
رائعة	Superb
انتشار	Spread
لصالح	For
التعمين	Omanisation
سكان	Population
مالية	Financial
ابرز	Most
عقدت	Held
الشارع	Street
جوائز	Awards
العمانى	Omani
الاحد	Sunday
الاسهم	Shares
ظهور	Emergence
مساعد	Assistant
بأي	Any
المشاهد	Scenes
صفوف	Ranks
المعاني	Meanings
تساعد	Help
الاسرة	Family
المصدر	Source
الناحية	Hand
والكهرباء	And
سر	Secret
الشخص	Person
حي	District
الشمالية	North
انجاز	Completion
تزيد	More
واسع	The
استراتيجية	Strategy
المعروف	Known
الجامعات	Universities
المشاكل	Problems
فازت	Won
به	By
للتربية	Educational
عين	Appointed
تشجيع	Encourage
تستطيع	Post
الجهد	Voltage
السويق	Suwaiq
العمليات	Operations
ويتم	And
قرية	Village
إنها	It's
فهذه	These
اقتصادية	Economic
بأهمية	The
بها	By
اولا	First
وزيادة	And
أسباب	Reasons
الفائدة	Interest
القانونية	Legal
قلوبهم	Hearts
ويعتبر	The
اربع	Four
لعب	Played
نقول	Say
الخط	Line
وغيرهم	And
أنواع	Types
اثنين	Two
الذهب	Gold
النور	Light
نطاق	Range
جون	John
فلسطين	Palestine
التصوير	Photography
الي	To
إنسان	Man
يقال	Said
خطأ	Error
الزكاة	Zakat
التنسيق	Coordination
والمجتمع	And
جملة	Total
المتنوعة	Miscellaneous
يشهد	Testifies
أولى	First
يسمى	Called
المستمر	Continuous
الافتتاح	Opening
جرت	Held
قليلا	Bit
وسجل	Scored
الإعجاز	Miracles
صغيرة	Small
تقريبا	Almost
أوروبا	Europe
اسيا	Asia
سابقا	Previously
للفنون	Art
شعار	Logo
جورج	George
جمال	Jamal
اقل	Less
الجسم	Body
الفرنسية	French
رفض	Rejected
يتحدث	Speaks
رصيده	Tally
رد	Re
شاركت	Participated
وجدت	Found
الاتصال	Contact
سليم	Slim
تفعيل	Activating
هريرة	Hurayrah
المسلمة	Muslim
لوكالة	Told
المائية	Water
تربية	Education
دبي	Dubai
البلد	Country
الصالح	Good
وقبل	Before
مائة	Hundred
الاجنبية	Foreign
الصدارة	Top
سير	Sir
السابعة	Seventh
وإلى	And
تسجيل	Recording
الغرفة	Room
فوزه	Winning
فرقة	Task
فنحن	We
جديدا	New
تؤدي	Lead
القرآني	Quranic
حارس	Guard
الموقع	Site
الترتيب	Ranking
بمثابة	A
المتداولة	Traded
بمعنى	Meaning
منح	Granted
الدائرة	Circle
تشمل	Include
ذهبية	Gold
حرص	Keenness
نص	Text
التعبير	Expression
قواعد	Rules
ورفع	And
ل	For
سياسة	Policy
تظهر	Show
الاسيوية	Asian
مشتركة	Joint
جل	Gel
يعتمد	Supports
المستقبلية	Future
الوجود	Presence
ببعض	Some
النحو	As
قصيدة	Poem
الصحيحة	Correct
يتطلب	Requires
معدلات	Rates
لندن	London
للجنة	Committee
مدة	For
الاتفاقية	Convention
أشار	Indicated
وادي	Valley
معا	Together
متطلبات	Requirements
افراد	Members
التداول	Trading
مكافحة	Against
الجلسة	Session
التعرف	Identified
حرب	War
المشروعات	Projects
الحقوق	Rights
ويرعاه	And
تعريف	Definition
الشيء	Thing
ينظر	Seen
طيبة	Good
للاستثمار	To
الجزائر	Algeria
العالمين	Worlds
دمشق	Damascus
الحرية	Freedom
فضل	Preferred
المؤسسة	Enterprise
تمكن	Enable
القصة	Story
المتاحة	Available
المشاركات	Posts
لتكون	To
وتابع	And
الخمر	Wine
سداب	Sidab
لمجلس	Council
الحارثي	Harthy
يقولون	Say
ويجب	And
اليد	Hand
سؤال	Question
المطلوبة	Required
الحادي	Atheist
أراد	Wanted
للتنمية	Development
زيد	Zaid
الحالى	Current
المؤلف	Author
ضعف	Weakness
الحالات	Cases
أقل	Less
فيهم	Including
الطبيعة	Nature
حصلت	Got
بدول	States
قيادة	Leadership
الجماهير	Masses
الدراسية	School
بواسطة	By
كمية	The
رحمه	Mercy
تحسين	Improve
السنوي	Annual
والتعاون	And
وايضا	And
منهج	Approach
جزاء	Penalty
والثاني	The
القيمة	Value
التسجيل	Join
وبحضور	And
المدنية	Civil
مؤشر	Index
واضح	Clear
لديها	Has
المهارات	Skills
يصبح	Becomes
اتخاذ	Take
فاذا	If
المجتمعات	Communities
المادية	Material
ارض	Land
صعوبة	Difficulty
تصريح	Permit
وبذلك	Thus
أشهر	Months
الكتابة	Writing
قدرة	Capacity
والخدمات	And
اسمه	Named
السورية	Syrian
ذهب	Went
تجمع	Gathered
الشأن	Issue
لتطوير	To
غيرها	Other
البريطاني	British
استغلال	Exploitation
الإعلام	Media
عرف	Identified
تكريم	Honoring
الحكيم	Hakim
والمؤسسات	And
جهاز	Device
زمن	Time
الذكر	Above
حاول	Try
أننا	We
الاربعاء	Wednesday
الموضوعات	Topics
بغير	Without
يشعر	Feel
وتحقيق	And
أين	Where
وبما	And
الطيبة	Good
هما	Two
الضوء	Light
وأنه	And
خطط	Plans
ويأتي	The
لحظة	Moment
العمال	Workers
نفسي	Myself
مواقع	Sites
القومي	National
البيئية	Environmental
السفر	Travel
سوء	Ill
عليكم	You
شرق	East
الحيوانية	Animal
حملة	Campaign
عظيم	Great
الأهداف	Targets
هدفا	Target
وفد	Delegation
بنك	Bank
بتقديم	Providing
الكهرباء	Electricity
لديهم	Have
مر	Over
بطل	Champion
شباب	Youth
سبعة	Seven
وله	Has
ربك	Lord
حقا	Really
تبقى	Remaining
القرآنية	Quranic
كلما	Whenever
نفسك	Yourself
تعود	Back
الشديد	Serious
اشار	Said
البلدان	
جماعة	Group
وتقول	Says
الفقه	Jurisprudence
إحدى	One
الايمان	Faith
الدخل	Income
موعد	Date
جزءا	Part
ولكنها	But
الحدث	Event
بي	P
الخطط	Plans
الرسمية	Official
اليمن	Yemen
غدا	Tomorrow
اكتوبر	October
الجوائز	Awards
بقية	The
المسرحي	Playwright
وابن	And
جمعية	Society
نمو	Growth
الهلال	Crescent
اشهر	Months
هامة	Important
الحقيقي	Real
أساس	Based
ذكره	Said
بانه	As
المملكة	Kingdom
وسيلة	Means
وأوضح	The
شأن	Like
كامل	Full
البريطانية	British
النفطية	Oil
الاجتهاد	Ijtihad
وجد	Found
الشرعية	Legitimacy
واحدا	One
الجماعة	Community
القسم	Section
الدكتورة	Dr
فكيف	How
الطب	Medicine
الربيع	Spring
شتى	Various
مستويات	Levels
تقع	Located
توفر	Provide
المعلمين	Teachers
نصيب	Per
طريقة	Way
التوالي	Respectively
التعلم	Learning
المكتب	Office
وقوله	And
أنفسهم	Themselves
الامام	Imam
العين	Eye
الاخر	The
العروض	Offers
الحقيقية	Real
القوانين	Laws
هكذا	Thus
صدر	Issued
تبلغ	Of
تزال	Still
المناسب	Appropriate
الثامن	VIII
التالي	Next
صحيح	True
العدد	Number
النفسية	Psychological
السياسة	Politics
وكالة	Agency
روي	Roy
حالات	Cases
الرسالة	Message
اجراء	Hold
أسعار	Prices
قيل	Said
قمة	Summit
الاتفاق	Agreement
الوزير	Minister
بقدر	As
الارهاب	Terrorism
الدم	Blood
امر	Ordered
المدرسية	School
مناسبة	Appropriate
مسعود	Massoud
الصادرات	Exports
موضحا	Adding
غياب	Absence
محل	Replace
تبارك	Blessed
يهدف	Aims
الجدير	Worth
بطاقة	Card
تدخل	Enter
تحتاج	Need
لقب	Title
بأنها	As
الثلاثاء	Tuesday
الاستثمارات	Investments
متنوعة	Miscellaneous
آسيا	Asia
رؤية	See
القواعد	Rules
اتفاقية	Convention
تبادل	Exchange
مفهوم	Concept
الخابورة	Khabourah
أداء	Performance
ذوي	With
صدام	Saddam
ثانيا	Second
ويضيف	And
ليكون	To
الحسن	Hassan
اليومية	Daily
الرعاية	Care
العلوي	Top
الثروة	Wealth
الفكرة	Idea
الكون	Universe
السادسة	Sixth
الخارج	Abroad
أحسن	Best
الفنانين	Artists
عنده	Has
يدعو	Calls
جدول	Table
يبقى	Remains
دعوة	Call
الوسائل	Means
لبعض	Some
افريقيا	Africa
بدء	Start
داود	David
اللعب	Playing
يحب	Loves
المؤمن	Insured
انتهاء	End
التنفيذي	Executive
عيسى	Isa
ويمكن	And
ارتفع	Rose
خطوة	Step
ابريل	April
الأميركي	US
يحصل	Gets
عمله	His
الصحابة	Companions
نهائيات	Finals
المراحل	Stages
حزب	Party
أفب	AFB
الزمان	Time
المواضيع	Threads
معهم	With
اقيمت	Erected
بصفة	In
وتقديم	And
أثر	Impact
النصوص	Texts
العمر	Age
الاوروبي	European
الزيارة	Visit
الرياضة	Sports
الأساسية	Basic
اعلن	Announced
محاضرة	Lecture
الخروج	Exit
الجزء	Part
البوسعيدي	Busaidi
بحث	Search
السيارات	Car
جانبه	Part
الفكرية	Intellectual
جوانب	Aspects
الحفاظ	Maintaining
الانسانية	Humanity
طرح	Put
نرى	See
لدينا	We
الهند	India
الكلام	Speech
مدريد	Madrid
واسعة	Range
وعلي	Ali
الاداء	Performance
الكريمة	Precious
الاثنين	Monday
إقامة	Establishment
وزراء	Ministers
اصبحت	Became
المرافق	Utilities
تخرج	Graduated
القراءة	Reading
يشكل	A
تجاه	Towards
النوع	Type
الماضى	Last
متعددة	Multiple
نجاح	Success
الجهة	The
غرفة	Room
العلاج	Therapy
بقيادة	Led
حديثه	Speaking
آلاف	Thousands
الساحة	Arena
ولعل	Perhaps
القائمة	Existing
اوروبا	Europe
بدر	Badr
المعمري	Ma'amari
المرة	Time
اجمالي	Total
الهنائي	Hinai
الشعرية	Capillary
تأثير	Impact
القمة	Summit
المنهج	Approach
فن	Art
سلسلة	Series
لبنان	Lebanon
ركلة	Kick
الهجمات	Attacks
البيان	Statement
انا	I
أبا	Abba
للشباب	Youth
العيد	Day
الحدود	Border
وعليه	And
طرق	Methods
الفرد	Individual
يعيش	Live
فهناك	There
الأسرة	Family
العروبة	Arabism
ووضع	And
حمود	Hammoud
السماوات	Heavens
حكومة	Government
اصبح	Became
الكلمة	Call
يضم	Includes
الامة	Nation
القدرة	Capacity
العناصر	Elements
دار	House
يبدأ	Begin
تمت	Has
النقد	Monetary
أصبحت	Become
بمختلف	Various
التاسع	IX
الحد	Limit
السبب	Why
العراقيين	Iraqis
تتعلق	About
فبراير	February
آمنوا	Believe
محطة	Station
أوصى	Recommended
أعضاء	Members
الشرع	Shara
ولهذا	For
وتوفير	And
قتل	Killed
التصفيات	Qualifying
الشريف	Sharif
مؤسسات	Institutions
صحيفة	Newspaper
اهتمام	Interest
الصناعة	Industry
علمية	Scientific
الموت	Death
سنويا	Annually
تواجه	Facing
تشكيل	Formation
الباحثين	Researchers
الهجوم	Attack
بقيمة	Worth
مال	Money
سبب	Reason
تشهد	Witnessing
القيادة	Leadership
الدخول	Access
نظر	View
واحمد	And
الأمم	United
البحريني	Bahraini
فرض	Imposing
الغاز	Gas
المعارض	Exhibitions
دورا	Role
وجاءت	Came
ربه	Rabbo
المسؤولين	Officials
القى	Delivered
السلطات	Authorities
الحرام	Sacred
اغسطس	August
الاوسط	East
وأشار	The
الطعام	Food
لاعبي	Players
المصطلحات	Terminology
مجرد	Just
المخرج	Exit
يظهر	Shows
اليهود	Jews
وأما	The
يلعب	Plays
دخول	Log
ورقة	Paper
نوفمبر	November
التطور	Evolution
وتنمية	And
الصرف	Exchange
أمة	Nation
القطري	Country
القلوب	Hearts
دقيقة	Minute
التعداد	Census
بكر	Baker
يد	By
لغة	Language
موقف	Position
اللجان	Committees
السياحي	Tourist
مايو	May
كي	To
لجميع	For
المنتجات	Products
وذكر	The
يحيى	Yahya
التعريف	Definition
قضايا	Issues
مرمى	Throw
الخبرات	Experiences
وأكد	The
الأم	Mother
وربما	And
المواطن	Citizen
حفظ	Remember
مصطفى	Mustafa
مسألة	Issue
خيرا	Good
عهد	Era
التقنية	Technical
المدير	Director
مسيرة	March
حساب	Account
بعدما	After
والمياه	Water
تشارك	Involved
البحوث	Research
يزال	Still
وهنا	Here
اسرائيل	Israel
رأى	Saw
الخميس	Thursday
الخلق	Creation
الأسبوع	Week
يدل	Indicates
حضرة	Hazrat
القيم	Values
الواحد	Per
فوز	Win
لعام	Of
نور	Noor
النقاط	Points
المهمة	Task
السبت	Saturday
القضية	Issue
والتى	Which
يقع	Located
الخبرة	Experience
للناس	
تطور	Evolution
معدل	Rate
يبلغ	A
المعلم	Teacher
القضاء	Eliminating
القارئ	Reader
الحب	Love
والعشرين	Twenty
يملك	Owns
بلاده	His
الأمن	Security
ولن	Not
ستة	Six
حضر	Attended
مسرح	Theater
اثينا	Athens
الملك	King
معينة	Certain
كوريا	Korea
يبدو	Apparently
تضم	Includes
الاعضاء	Member
التابعة	Of
رويترز	Reuters
تهدف	Aims
الطبية	Medical
المسلحة	Armed
بقوة	Strongly
الإنسانية	Humanities
تناول	Eating
رضى	Satisfaction
النهاية	Eventually
المواقع	Sites
يدخل	Enters
الصحيح	Right
يعلم	Teaches
الخطة	Plan
عقب	After
بيد	However
الظروف	Conditions
وأنا	I
الاسعار	Prices
الدورات	Courses
الاسواق	Markets
القائم	Existing
وصناعة	And
الموقف	Position
انتاج	Produce
مؤسسة	Foundation
القوة	Force
ورد	WordPress
وانه	And
الغذائية	Food
عبري	Hebrew
الوحيد	Only
أنت	You
المصرية	Egyptian
بطريقة	Way
الفلسطيني	Palestinian
المطلوب	Required
خرج	Output
بزيارة	Visit
لديه	Has
السادس	VI
والأرض	Earth
والثروة	Wealth
الادارية	Administrative
لكنها	But
التخطيط	Planning
الأزهر	Azhar
الوعي	Awareness
بالفعل	Already
يحفظه	Keeps
وكيف	How
البنك	Bank
الرحمن	Rahman
أنهم	They
طبيعة	Nature
اربعة	Four
قيمتها	Worth
شهد	Saw
التقليدية	Traditional
الدرجة	Class
السابع	VII
الانترنت	Online
الأيام	
أربعة	Four
الاساسي	Basic
نوع	Type
قصة	Story
عنوان	Title
الاجراءات	Measures
ندوة	Seminar
اثناء	During
إطار	Under
خمس	Five
وانما	But
التاريخية	Historic
السياسي	Political
الرأي	Opinion
تشكل	Form
مدارس	Schools
وكما	As
الأب	Father
فرنسا	France
عمانيا	Omani
المشكلة	Issue
تبدأ	Begin
والثقافة	And
المنتخبات	Teams
قراءة	Read
الجمعة	Friday
الملعب	Pitch
ممثلة	Represented
تقرير	Report
بفضل	With
صحة	Health
الاوروبية	European
الايام	Days
أعلى	Top
أهداف	Targets
كنا	We
المقدمة	Provided
تغيير	Change
النتيجة	Score
هيئة	Authority
ذي	A
الحارس	Ranger
الاحتفال	Celebrating
بلدية	Municipality
قائد	Commander
الهامة	Important
الحضارة	Civilization
النقل	Transport
دليل	Manual
يخرج	Out
حقق	Achieved
يجعل	Makes
جزء	Part
الصورة	's
المعنية	Involved
يؤكد	Confirms
الحاجة	Need
يناير	January
حماية	Protect
التقدم	Progress
خلاله	Which
الشعراء	Poets
الإيمان	Faith
الحالة	Status
آيات	Verses
بدلا	Instead
العظيم	Great
ام	M
مؤتمر	Conference
للسلطنة	Sultanate
ملعب	Stadium
حب	Love
أثناء	During
يحمل	Holds
ذلك	So
المصادر	Sources
حاجة	Need
المشتركة	Joint
ولايات	States
الرجال	Men
التشكيلية	Fine
المقرر	Scheduled
الثقة	Confidence
الجنوبية	South
يحقق	Achieves
عبارة	A
شكل	Form
المقبلة	The
ضوء	Light
الجهاز	Device
مسرحية	Play
وبعض	And
نشر	Published
الموجودة	Existing
قلب	Heart
ترى	See
محاولة	Try
الاتصالات	Communications
النمو	Growth
العزيز	Aziz
القديمة	Old
وصلت	Reached
ملايين	
فلما	When
منا	Us
الأطفال	Children
كبار	Top
جائزة	Award
روح	Spirit
الآيات	Verses
الحرفية	Craft
ورغم	Although
امرأة	Woman
خلف	Behind
قيام	Do
وفقا	According
إبراهيم	Abraham
ساعة	Hour
الكويتي	Kuwaiti
صعيد	Upper
السلطة	Power
ديسمبر	December
ترك	Leaving
بعضها	Some
الشيطان	Satan
مراكز	Centers
النشاط	Activity
الخامسة	Fifth
والى	And
سند	Support
تسعى	Seeks
الدراسي	School
مرات	Times
جابر	Jaber
البلديات	Municipalities
ظاهرة	Phenomenon
بمحافظة	Province
اللهم	O
بالولاية	State
العولمة	Globalization
الزمن	Time
جمع	Collect
بحاجة	Need
متابعة	Followup
الزراعي	Agricultural
التجربة	Experiment
الطلب	Demand
يونيو	June
اليابان	Japan
تدريب	Training
الطائرة	Plane
موقع	Site
المسابقات	Contests
دفع	Pay
وكيفية	And
البلدية	Municipal
مراحل	Stages
ذاته	Same
فنية	Art
اجتماع	Meeting
وتطوير	And
التجاري	Commercial
الخدمة	Service
أصبح	Became
التركيز	Focus
سبق	Above
الجنة	Paradise
عربية	Arabic
الجوانب	Aspects
العدل	Justice
القاعدة	Rule
والذين	And
يمثل	Represents
ممن	Who
المحكمة	Court
التقرير	Report
الثلاث	Three
تجربة	Experience
الغربية	West
للعمل	To
برئاسة	Headed
والي	And
سعود	Saud
واشنطن	Washington
درجة	Degree
راشد	Rashid
قلت	I
اداء	Perform
بحضور	The
قاعدة	Base
وحدة	Unit
كم	
كلا	Both
راعي	Patron
ربع	Fourth
حدود	Borders
بقوله	Saying
القطاعات	Sectors
الاساسية	Basic
واضحة	Clear
معلومات	About
دخل	Income
المغرب	Morocco
البناء	Building
يحدث	Occurs
يسعى	Seeks
فهذا	This
انهم	They
شاء	Wills
عصر	Age
صناعة	Industry
وهى	A
سجل	Record
الآخرين	Others
حلقة	Episode
فاطمة	Fatima
مصدر	Source
شبكة	Network
طوال	Over
وموارد	And
توزيع	Distribution
بعيدا	Away
يحتاج	Needs
جيد	Good
يجد	Find
الصغيرة	Small
العسكرية	Military
فضلا	As
الوهيبي	Wahaibi
ليلة	Night
الاباضية	Abadites
جمعة	Juma
ايجاد	Find
المتوقع	Expected
الوحدة	Unit
صلاة	Prayer
ابو	Abu
الفنون	Arts
يشارك	Involved
السمكية	Fish
استطاع	Managed
سوريا	Syria
سعد	Saad
الدعم	Support
الحضور	Attendance
شارك	Participated
معنى	Meaning
بالذكر	Mentioning
والصناعة	And
فيقول	Says
شخصية	Personal
مهما	Whatever
وعندما	When
إدارة	Management
للمرة	Time
الأخيرة	Last
لماذا	Why
طويلة	Long
الرئيسي	Parent
ثانية	Second
الحلقة	Episode
النجاح	Success
مواجهة	Face
ايران	Iran
فانه	It
القرية	Village
واقع	The
المعسكر	Camp
لانه	Because
القيام	Do
بالإضافة	Plus
فاز	Won
اللاعب	Player
المشترك	Joint
عناصر	Elements
المكان	Place
الفصل	Chapter
مليار	Billion
قل	Say
الرغم	Although
والاجتماعية	The
البنوك	Banks
البشر	Humans
البيانات	Me
زيارة	Visit
الانشطة	Activities
تعرض	Exposure
وهل	Will
عليك	You
فعل	Act
تحقق	Check
تراجع	Decline
علما	Note
لذا	So
بيع	Sale
منهما	Their
الاحتلال	Occupation
قرار	Resolution
مناقشة	Discuss
الشريعة	Sharia
تجارة	Trade
العالي	Higher
المرمى	Goal
مياه	Water
بمشاركة	With
باب	Door
أولا	First
للمشاركة	Post
آية	Verse
التفكير	Thinking
تجد	Find
المراكز	Centers
القول	Say
لأنها	They
رسالة	Message
هلال	Hilal
الحال	Case
شرطة	Police
خليفة	Khalifa
ماذا	Why
شخص	Someone
قدر	Estimated
المسئولين	Officials
الزواج	Marriage
المسلمون	Muslims
والبيئة	And
فتح	Open
مثلا	For
اسم	Name
واكد	And
التدريبية	Training
أيها	O
عالية	High
حل	Solution
معرفة	See
الفرص	Opportunities
الفريقين	Teams
الوفد	Delegation
علماء	Scholars
الكلية	College
العلاقة	Relationship
اعادة	Re
النص	Text
دين	Dean
عائشة	Aisha
المزيد	More
الشمس	Sun
تونس	Tunisia
تقام	Held
مارس	March
والثقافية	And
الروح	Spirit
الكاتب	By
تعزيز	Promotion
وهكذا	Thus
اسهم	Shares
الفرنسي	French
توجد	There
بعضهم	Some
الطبيعي	Natural
فكان	Was
سباق	Race
يوليو	July
وفى	In
كتابه	Book
يزيد	More
فرق	Teams
ناحية	Hand
عديدة	Many
أكد	Confirmed
لاعب	Player
العاصمة	DC
مكتب	Office
ريالا	SR
جهود	Efforts
خدمات	Services
تصل	Up
لدول	Countries
الاخير	Last
قائمة	List
مؤكدا	Stressing
قضية	Issue
تطبيق	Application
يصل	Up
العليا	Supreme
الاطفال	Kids
خلفان	Khalfan
النتائج	Results
النهضة	Renaissance
رب	Lord
معها	With
المعرفة	Knowledge
طالب	Student
رواه	Narrated
الأمور	Things
السينما	Film
إضافة	Add
الشعب	People
الشخصية	Personal
الحالية	Current
طلب	Order
حكم	Rule
واوضح	Said
ظهر	Noon
موسى	Moussa
خط	Line
خاص	Special
تمثل	Represent
العمانيين	Omani
البلدين	Two
المحلي	Local
بمنطقة	Region
اتحاد	Union
الشورى	Shura
المباريات	Matches
مشاريع	Projects
بينهما	Between
العرض	Display
الماء	Water
وراء	Behind
برميل	Barrel
الغرب	West
قانون	Act
المدرب	Trainer
الشعبية	People
الجمهور	Public
الاقليمية	Regional
الإمام	Imam
جيدا	Good
الاهداف	Targets
بهلاء	Bahla
يعود	Due
وصل	Arrived
الجلالة	Majesty
قدمت	Provided
وقع	Signed
قطر	Qatar
احدى	One
الباطنة	Batinah
الخطاب	Discourse
الموارد	Resources
الكتب	Books
المصري	Egyptian
كيفية	How
دعم	Support
تعمل	Works
بالمركز	Center
أعمال	Of
الثلاثة	Three
الاسلامي	Islamic
الطاقة	Energy
حدث	Event
مكة	Mecca
مادة	Article
فهم	Understanding
التعادل	Tie
معاليه	Ma'aleh
يعمل	Works
واذا	If
رأس	Header
يقدم	Offers
اكد	Said
الوضع	Situation
مشكلة	Problem
أصحاب	Owners
فكرة	Idea
السيد	Mr
فيلم	Film
ال	The
فلم	No
التربوية	Educational
حجم	Size
نصف	Half
اثر	After
أنا	I
النهائية	Final
الخير	Good
المستقبل	Future
يؤدي	Leads
الامور	Things
السياحة	Tourism
المادة	Article
تأتي	Come
وحول	And
ختام	The
يوميا	Daily
الرواية	Novel
العاملين	Workers
الوصول	Access
محمود	Mahmoud
عباس	Abbas
ولكنه	But
بهم	Their
قالوا	Said
خميس	Khamis
بلا	Without
العلوم	Science
عضو	Member
الفرصة	Opportunity
ابراهيم	Ibrahim
المحافظة	Maintaining
عما	What
يجوز	May
نفسها	Same
وسوف	Will
شمال	North
اهداف	Goals
السنوات	Years
الاعلام	Media
مدرب	Coach
المتعلقة	Of
التراث	Heritage
القرار	Resolution
بجامعة	University
بالتعاون	Cooperation
حصل	Won
س	Q
حديث	Interview
السعودي	Saudi
تحمل	Carrying
المسرحية	Theatre
شك	Doubt
عامة	Actions
السلطانية	Bowl
تعد	The
الفيلم	Film
الليل	Night
الطبيعية	Natural
والعمل	And
حقيقة	The
سلطان	Sultan
اننا	We
الحوار	Dialogue
تحديد	Identifying
إلي	To
بينها	Including
اهم	Most
السباق	Race
وكيل	Under
الامارات	Emirates
انشاء	Generation
الباحث	Researcher
شركات	Companies
الجاري	Current
اللازمة	For
ستكون	Will
برصيد	With
موضوع	Multi
البلاد	Country
جيدة	Good
ربما	Maybe
اصحاب	Owners
سيف	Saif
علاقة	Relationship
جعل	Make
حقوق	Rights
البحر	Sea
وتم	Was
تقول	Says
التربوي	Educational
خمسة	Five
تكن	Not
يريد	Wants
خطة	Plan
الموضوع	Version
المعظم	Muadham
الخليجي	Gulf
اختيار	Selection
الاستفادة	Benefit
البلوشي	Baloch
الخامس	V
منافسات	Competitions
فوق	Above
البحرية	Navy
بغداد	Baghdad
بصورة	In
لكي	To
اذ	Since
بوزارة	Ministry
مهمة	Mission
أيام	Days
الرابعة	Fourth
وسائل	Means
السعادة	Happiness
الامن	Security
لتحقيق	For
السياحية	Tourist
مباريات	Matches
وفق	According
الدينية	Religious
السماء	Heaven
نظرا	Due
مبارك	Mubarak
لمدة	For
والسلام	Peace
النساء	Women
الالعاب	Games
حسين	Hussein
ألف	A
اللقب	Title
النصر	Victory
يوما	Day
البداية	Beginning
الجيش	Army
الملتقى	Forum
خدمة	Service
نقل	Transport
الصحي	Health
أ	A
بشأن	On
وغير	And
الجمعية	Assembly
الزراعة	Agriculture
القانون	Law
ايام	Day
الوزراء	Minister
الدراسات	Studies
شهدت	Seen
فإنه	It
اليها	It
السيب	Seeb
عددا	Number
الأميركية	US
السياسية	Political
معظم	Most
الكبيرة	Big
مجالات	Areas
للتعليم	Education
الانتاج	Production
وجل	Almighty
لكم	You
افتتاح	Opening
سوى	Only
بيان	Statement
باسم	As
بدون	Without
تماما	Completely
الانتخابات	Election
يستطيع	Can
السلطاني	Royal
اعداد	Numbers
القلب	Heart
الفن	Art
ينبغي	Should
معرض	Gallery
فإذا	If
مصادر	Sources
يعرف	Knows
التعامل	Dealing
بني	Built
التعليمية	Educational
الجولة	Round
القضايا	Issues
الحركة	Movement
بيت	House
ولذلك	Therefore
منظمة	Organization
قوة	Force
الزراعية	Agricultural
المهندس	Engineer
الرياضي	Sports
الظاهرة	Phenomenon
أهمية	Importance
نجد	Find
ومنها	And
قسم	Section
بالمنطقة	Region
القوات	Forces
الرئيسية	Home
وعدد	The
القرن	Century
مؤخرا	Recent
يوجد	There
الجامعة	University
وجاء	The
المجالات	Areas
قول	Say
الخليجية	Gulf
المسجد	Mosque
مباشرة	Directly
الصناعات	Industries
لكنه	But
فهل	Will
رمضان	Ramadan
المواطنين	Citizens
بد	Must
الشرقية	East
رعاية	Care
حد	End
الامم	UN
المنافسة	Competition
الموسم	Season
ج	C
الدعوة	Call
برامج	Programs
لقاء	Meet
ألا	Not
الشاعر	Poet
نتائج	Results
عالم	World
الشرطة	Police
الفعاليات	Events
اخر	Another
عمليات	Operations
أهم	Key
إنما	But
الادارة	Administration
تاريخ	Date
اعمال	Acts
يذكر	The
العلاقات	Relations
تحدث	Occur
دوري	League
يوسف	Yousef
الحصول	Get
وسط	Middle
رقم	No
ومحمد	And
البعض	Some
الاجتماعي	Social
سعادته	Happiness
كلية	Faculty
جميعا	All
مسلم	Muslim
خصوصا	Especially
سبتمبر	September
اسعار	Prices
الثقافة	Culture
رجال	Men
العقل	Mind
الجهود	Efforts
واشار	He
حوالي	About
الدفاع	Defense
بينهم	Including
أكبر	More
الطالب	Student
الجهات	Actors
الطرق	Roads
إنه	It's
قوات	Forces
الدراسة	Study
ارتفاع	Rise
لأنه	Because
دراسة	Study
ونحن	We
صورة	Photo
آل	Al
المواد	Materials
مختلفة	Different
مناطق	Areas
الفنان	Artist
جهة	Point
الاهتمام	Interest
النادي	Club
يرى	Sees
حفل	Ceremony
محافظة	Province
الأعمال	Business
المديرية	Directorate
ففي	In
رفع	Lift
مقارنة	Compared
اعضاء	Members
فرص	Opportunities
الفكر	Thought
متر	M
اكبر	Larger
العالمي	Global
الطلبة	Students
يتعلق	The
استخدام	Use
النظام	System
وإذا	If
المسرح	Theater
تنظيم	Organize
بالسلطنة	Oman
أفضل	Best
خالد	Khalid
وإنما	But
العملية	Process
الثقافي	Cultural
الف	Thousand
المقبل	Next
المحلية	Local
لمن	Those
الطلاب	Students
الصين	China
لك	You
قوية	Strong
يعني	Means
عز	Ezz
حركة	Movement
بيسة	Bz
البيت	House
ضرورة	Need
المائة	Percent
الآية	Verse
تعتبر	The
علينا	We
وأضاف	The
صلالة	Salalah
لابد	To
وخاصة	Especially
بعنوان	Titled
البرامج	Programs
الولاية	State
بأنه	As
بعدها	After
ولقد	The
معه	With
ليست	Not
مشاركة	Post
الشعر	Hair
سيتم	Will
الشرق	Middle
القاهرة	Cairo
حال	If
دورة	Cycle
الاقتصادي	Economic
السنة	Year
التاريخ	History
خلق	Create
المشاركين	Participants
توفير	Provide
خير	Good
سليمان	Suleiman
اقامة	Establish
الارض	Earth
الاستثمار	Investment
حق	Right
الساعة	Time
جنوب	South
وقالت	Said
المدارس	Schools
المدرسة	School
البرنامج	Program
نزوى	Nizwa
تنمية	Development
خارج	Outside
بنسبة	By
مرحلة	Stage
بوش	Bush
منتخب	Elected
الصناعية	Industrial
يعد	The
إذ	Since
الامر	It's
السعودية	Saudi
عقد	Held
سعر	Price
التدريب	Training
دائما	Always
وجه	Face
سيكون	Will
مهرجان	Festival
الاميركي	US
الحرب	War
العراقية	Iraq
ومع	With
صحار	Sohar
البحرين	Bahrain
السابقة	Previous
اول	First
مكان	Place
اطار	Part
فما	What
الفرق	Difference
العلمي	Scientific
المسابقة	Competition
العلماء	Scientists
حياة	Life
قيمة	Value
البيئة	Environment
بدأ	Began
مصر	Egypt
وعدم	And
قالت	Said
نظام	System
والتعليم	Education
الندوة	Symposium
ناصر	Nasser
وبالتالي	And
يعتبر	The
الدوري	League
أمر	Is
بحيث	So
كنت	I
الاقتصاد	Economy
اهمية	Importance
نقاط	Points
النظر	Of
الصحة	Health
بالمائة	Percent
المنظمة	Organization
ثلاث	Three
يأتي	Comes
التجارية	Commercial
الان	Now
سهم	Shares
ذكر	Male
البحث	Search
نائب	Vice
نسبة	Ratio
وتعالى	The
الحكومية	Government
الاسبوع	Week
الحديثة	Modern
الهيئة	Authority
الحكم	Governance
المؤسسات	Institutions
افضل	Best
نحن	We
مساء	Pm
الرابع	Fourth
نادي	Club
الجميع	Everyone
كثير	Many
أجل	For
المناطق	Areas
صور	Images
الثقافية	Cultural
حسب	By
ظل	Under
وكل	All
بلغ	Reached
رجل	Man
علم	Science
سورة	Sura
قامت	The
خلالها	During
بدأت	Started
القادمة	Coming
بذلك	So
قدم	Ft
مسابقة	Contest
الكرة	Ball
مدرسة	School
الجديدة	New
وحتى	Until
أهل	People
المناسبة	Appropriate
الحفل	Concert
هدف	Target
وهناك	There
عرض	Show
جامعة	University
الاولمبية	Olympic
عشرة	Ten
الشهر	Month
صالح	Saleh
اللغة	Language
سوق	Market
الفني	Technical
قطاع	Gaza
المشاريع	Project
اللقاء	Meeting
دائرة	Department
الاعمال	Business
مدى	Over
بولاية	State
صباح	Morning
فمن	It
الرجل	Man
أنها	It
قائلا	Saying
الخارجية	Foreign
فهي	It
المستوى	Level
حسن	Hassan
تقدم	Offers
لله	God
جاءت	Came
بناء	Building
كانوا	Were
العراقي	Iraq
الطريق	Road
مدينة	City
لان	Since
الثالثة	Third
جديد	New
دولة	State
بلغت	Amounted
ضد	Against
الرياضية	Sports
الحالي	Current
ولو	Though
كبيرا	Great
وقت	Time
الجانب	Side
أحمد	Ahmed
المعرض	Exhibition
تنفيذ	Implementation
أول	The
الحج	Hajj
اليه	Him
فرصة	Chance
عماني	Oman
حمد	Hamad
الاسلامية	Islamic
الحق	Right
بينما	While
الشركة	Company
الكويت	Kuwait
سبيل	For
السوق	Market
اضافة	Add
بهدف	To
اللاعبين	Players
الكبير	Big
تطوير	Development
زيادة	Increase
أبي	Abi
ادارة	Management
كيف	How
المؤتمر	Conference
وهم	They
ويقول	Says
بكل	All
مشيرا	Pointing
تقديم	Provide
الاخيرة	Recent
الاجتماعية	Social
نتيجة	Result
الدقيقة	Minute
القوى	Forces
رغم	Although
بان	Ban
الدولة	Location
وبعد	After
وإن	The
الخدمات	Services
وبين	And
المسلم	Muslim
التجارة	Trade
الاجتماع	Meeting
لو	If
بهذه	This
سبحانه	Glory
هؤلاء	These
بهذا	This
القادم	Next
كتب	Wrote
فترة	Period
الداخلية	Interior
أم	Or
الخليج	Gulf
لكرة	Football
د	D
المجموعة	Group
أعلم	Know
العاملة	Working
بنت	Girl
الوطنية	National
اجل	For
وهذه	This
وضع	Put
وليس	And
ب	B
لي	Lee
الهدف	Target
معالي	HE
كلمة	Word
الشركات	Enterprises
بطولة	Championship
لهذه	This
كتاب	Book
هم	Are
برنامج	Program
الأولى	First
احد	One
لن	Will
المهرجان	Festival
المعلومات	Information
منهم	Of
مركز	Center
تقوم	The
كأس	Cup
مباراة	Match
فعاليات	Events
مشروع	Project
عليهم	They
أمس	Yesterday
يقوم	The
الآن	Now
حالة	Case
عدة	Several
الذى	Which
الصلاة	Prayer
الفوز	Win
العرب	Arabs
يكن	Not
التنمية	Development
أمام	Before
ظفار	Dhofar
الفنية	Technical
المالية	Fiscal
مقابل	Compared
الشوط	Half
الرسول	Prophet
الصحية	Health
سوف	Will
نفس	Same
المرحلة	Stage
نهاية	The
منتخبنا	Our
ثلاثة	Three
صاحب	His
الدولي	International
مرة	Visits
شركة	Company
بالنسبة	For
هنا	Here
حاليا	Currently
قوله	Saying
انها	It's
الاميركية	US
كرة	Ball
الوزارة	Ministry
قابوس	Qaboos
الاقتصادية	Economic
قام	The
التربية	Education
جديدة	New
بداية	Beginning
وجود	A
المشروع	Project
عشر	Tenth
الرئيس	President
كافة	All
لهذا	For
التعليم	Education
لجنة	Committee
عمر	Omar
وعن	And
عبر	Through
ولاية	Mandate
لكل	Per
بالاضافة	Plus
الوطني	National
المياه	Water
الولايات	States
الحكومة	Government
الدولية	International
تحقيق	Achieve
بسبب	Due
شهر	Month
داخل	Within
رضي	May
وكانت	The
احمد	Ahmed
ذات	Of
أبو	Abu
مجموعة	Group
النفط	Oil
لنا	Us
ر	
القدم	Foot
منطقة	Area
عملية	Process
وأن	And
فهو	Is
حين	While
اي	Any
المشاركة	Post
الكثير	Lot
المجلس	Council
الدور	Round
لما	Since
عدم	Not
الدورة	Session
لدى	In
القطاع	Sector
المرأة	Women
سواء	Both
واضاف	Said
أكثر	More
الوطن	Home
سالم	Salem
كذلك	Also
ضمن	Within
الثالث	Third
اكثر	More
وزير	Minister
كبيرة	Big
نحو	About
لأن	Since
والله	And
سعادة	HE
هل	Is
السلطان	Sultan
البطولة	Championship
نقطة	Point
ابن	Son
الفريق	Team
دول	States
فقال	Said
تحت	Under
اذا	If
اما	Either
جاء	Came
النبي	Prophet
دور	Role
لقد	The
مدير	Director
عبد	Abdel
طريق	By
فلا	No
الفترة	Period
جانب	By
التعاون	Cooperation
مستوى	Level
الدكتور	Dr
مختلف	Various
يجب	Should
امام	Before
فريق	Team
فان	Van
أما	The
فإن	The
الشباب	Youth
وكذلك	As
يتم	Is
مليون	Million
الوقت	Time
التى	By
ريال	SR
الاتحاد	Union
وعلى	And
العديد	Many
مجال	Field
والذي	And
خاصة	Private
اللجنة	Committee
يا	O
بشكل	In
ليس	Not
لكن	But
عمل	Action
المنتخب	Elected
مسقط	Muscat
عبدالله	Abdullah
دون	Without
إذا	If
جميع	All
ولم	No
وان	And
المباراة	Match
وزارة	Ministry
سعيد	Happy
الدول	States
امس	Yesterday
عندما	When
بأن	That
الشيخ	Sheikh
منذ	Since
مما	Than
يمكن	Can
الا	Only
تكون	Be
بما	Including
رسول	Messenger
مجلس	Council
العمانية	Oman
حول	About
فيما	In
بل	But
أنه	That
وكان	The
وهذا	This
يقول	Says
أي	Any
تلك	Those
المركز	Center
ولكن	But
مثل	Like
فقد	The
علي	Ali
يوم	Day
رئيس	President
وهي	A
عند	At
هناك	There
والتي	And
وما	And
تم	Was
عدد	Number
انه	He
وذلك	And
الذين	Who
إلا	Only
يكون	Be
غير	Is
هي	Is
إن	The
كانت	Was
بعض	Some
محمد	Mohammed
او	Or
وقال	Said
صلى	Prayed
قد	May
وهو	It
قبل	By
ثم	Then
عام	In
ومن	And
وفي	In
حتى	So
وقد	The
ولا	And
لم	
هو	Is
قال	
فى	
بعد	After
خلال	
أو	Or
كما	
كل	All
كان	
حيث	Where
بين	Between
مع	With
بن	Ben
الذي	
إلى	To
هذه	This
عن	
التي	
الى	
أن	
ان	To
على	
من	
في	
